Level size: 20
Polisher percentage: 50
Starter line: 11000011101000100111,
Whole Level:
1111111111111111111111
11E0000111110001111111
1101110010010011010001
1101000011010101010111
1101111000010000010001
1100100011010111000111
1111101011000100011111
1011001110010110000111
1000110010110001010011
11100001110G0000011111
1000100100011100000011
1111000101000110111011
1101010101111110001111
1101110111100000100011
1100000000001110101101
1101011010010000100001
1101010010010011101101
1001111111001010001001
10000011111011000111A1
1110101111101111000011
1111101111100111011111
1111111111111111111111