Level size: 10
Polisher percentage: 50
Starter line: 1010001110,
Whole Level:
111111111111
11E111111001
110001100011
110100001011
110101101011
110111G01011
100000011011
111111100011
110110001011
110000110011
1101110000A1
111111111111