Level size: 18
Polisher percentage: 50
Starter line: 010101101000101100,
Whole Level:
11111111111111111111
111E0011111101110001
11101100001100000101
10001110101100101111
11100011100000100111
11010101101010011111
11000000001011001011
11010110011001000011
11110110000111010111
1001010011G000011111
10000111000111100111
10000000011100001111
10111011000001010001
11000000011111110111
11111011001000000111
10000000000010010111
11001011010010111111
11110001011010000111
111101111110101100A1
11111111111111111111