Level size: 22
Polisher percentage: 50
Starter line: 0100101101011110100011,
Whole Level:
111111111111111111111111
111101111111111111111111
11E100000000010001000011
110110111111000111011111
110000110000010001000011
110111000111101111011111
110000011100000000000111
110111000001111011010011
110001011110001000111111
110100000000111010001011
110001010100001011110011
11001101110G111100000111
100001000011101101111011
100011011100000000000011
100001100110011111101111
100001101000000010110011
100000000010101110000011
100010101011110000101011
110000101000000111111001
110100000101010000000011
110101011000111111111011
110101011010000000010A11
111111011010111111111111
111111111111111111111111