Level size: 8
Polisher percentage: 50
Starter line: 01111110,
Whole Level:
1111111111
11111110E1
1100011011
1101000011
11100G0111
1000010001
1111010111
11A0000011
1111111001
1111111111