Level size: 18
Polisher percentage: 50
Starter line: 111100011001110100,
Whole Level:
11111111111111111111
111100001000111110E1
10110101001000001001
10000101111011100011
11111100100000001111
11100001101010100001
10001001001010111111
10001101111010100011
10010001000011101101
1011010101G000000001
11010101100011111101
11010101101000110011
11011100001010010111
11000001111011000001
11011010000001010111
11010010101100111011
11010010101100000011
11A10111101001111011
11111111101100111111
11111111111111111111