Level size: 10
Polisher percentage: 50
Starter line: 0001101010,
Whole Level:
111111111111
1000111100E1
100000000111
100100010011
110101001111
110111G11001
110001101101
110100000001
100001011101
100101011111
1A1111011111
111111111111