Level size: 12
Polisher percentage: 50
Starter line: 001001110111,
Whole Level:
11111111111111
1E011111101111
10010000000001
11010101101111
11000111000001
11010000010111
10001111010001
10000G01010111
10010101011111
11000101000111
11100000010111
10000110110111
1111011001A111
11111111111111