Level size: 22
Polisher percentage: 50
Starter line: 0011111000001100011100,
Whole Level:
111111111111111111111111
1E0111100000011000111111
110011101000000100000111
111001001111111101010111
110011101011000001010111
100011100001010111011111
111001001111010000000111
110011010000011110100111
100011011011001110110111
111001000000100001101111
110011011110101100000011
10000000011G110101011111
111011010001100101000011
100010010111000101111011
100110010000010100010011
100011001011010101011111
100011111101010111000111
100001110001010011010111
100100000101011001011111
110001101101000111000111
111101100100010000101111
10000010001011001010A111
111101111110011110111111
111111111111111111111111