Level size: 16
Polisher percentage: 50
Starter line: 0001111101100011,
Whole Level:
111111111111111111
1E0011111110000111
100001100000100011
100100001010101001
110001101110100011
111101000000001011
100001011001011011
101101001011001001
1010011G1000100011
110011111010111011
111000010000011011
100011111101001001
101001101101011001
111000001001010011
110001101011011111
111101001001000A11
111101111111011111
111111111111111111