Level size: 10
Polisher percentage: 50
Starter line: 0011110010,
Whole Level:
111111111111
1001111110E1
110010000011
110000101111
110110100011
11011G001111
110100100011
110110101101
110100100001
110101101001
1A0111101111
111111111111