Level size: 10
Polisher percentage: 50
Starter line: 0100000001,
Whole Level:
111111111111
111000000E11
111000000011
100010001011
111011111111
10000G000011
100011011011
100001100011
100001111111
100000001111
1A0110111111
111111111111