Level size: 18
Polisher percentage: 50
Starter line: 110011110000010100,
Whole Level:
11111111111111111111
110001110000011000E1
11010000011100001101
10000010111010110011
11101010000011100011
10001010111000001011
11101110000110101001
10000000110010100011
1010011001G100101011
10110010011101110011
11111010000100010111
11000010001101010111
11111011000101010011
10000001011101011111
11001001001001001011
11111101011000101011
10110001001010011011
1A000101111010000011
11101100111011110111
11111111111111111111