Level size: 16
Polisher percentage: 50
Starter line: 0101010110110001,
Whole Level:
111111111111111111
1111E1111111111111
111000100100010011
111010101100111011
100110001101001011
110000011001011001
110111001000011001
110101100101100011
1101000001G1101111
110111010100000001
110000010101101111
111011110111100001
110001100000000111
111100011111010001
110011000000110111
111000001110000001
1110111011000000A1
111111111111111111