Level size: 8
Polisher percentage: 50
Starter line: 00010110,
Whole Level:
1111111111
1E00111001
1000000011
1110G10111
1111100001
1101101001
11000010A1
1100100011
1110101111
1111111111