Level size: 24
Polisher percentage: 50
Starter line: 011010111001011001010110,
Whole Level:
11111111111111111111111111
11111111111111110111111111
11000100001100000110111111
11001111000101010000101111
110100110111010101111010E1
11011000001001010000100001
11001011011111011110100001
11101011000000000110101001
11101010010111110010101101
10101011110100011111101011
10001100000101000001001011
10000101101101111111011011
10011110101100000100000011
10000000101001111100011011
1011101010101G001101011011
11111010101010101101001101
11000010100010100101111001
11110111000110111101000011
10000010100000110001011011
11111010001111000111011011
10000011101000000000001101
11101010000001101011010001
10001000000101101111000111
10101100001000101001010111
1A111110011011101100001111
11111111111111111111111111