Level size: 16
Polisher percentage: 50
Starter line: 1111010000000101,
Whole Level:
111111111111111111
1111111000000000E1
100000000000001101
110010000110100111
111000010110101111
100001010100100011
111101010101111011
110101000100001011
110101010G01001001
110101010101000011
110101010101110111
110111010100011111
110000010010000111
110110111010000011
110100001011001111
110111101001011111
11A011111101111111
111111111111111111