Level size: 22
Polisher percentage: 50
Starter line: 0011101100001010101101,
Whole Level:
111111111111111111111111
111111010011111011111111
111E00000101000001000011
111010100100010101110111
111010110100111100110001
111111000100000010100111
110100010110111110101011
110101010000000010000011
110101011110101010101101
110101001000101011101001
110111111010101110001101
1100001000101G1101011001
111110101010111000000011
110000101010100111010111
111010111010101100010001
111010000010000101000111
100011111110101101100111
101100000000100011000001
111001011110101010110111
110010001000101010010001
111010101011101010110111
111010101100001000000001
1110111011011110110000A1
111111111111111111111111