Level size: 16
Polisher percentage: 50
Starter line: 1111101001001101,
Whole Level:
111111111111111111
111111111011111111
110000000000000E11
110101011110010111
110101000110010001
110111110001111001
110000011110110101
11101100G000000111
111000111011010011
100010001001011001
100011100101000011
100000010101001011
100110010111101011
110010110000101011
110100010111111011
1A0101010000000111
111111011111110111
111111111111111111