Level size: 18
Polisher percentage: 50
Starter line: 011100111000110111,
Whole Level:
11111111111111111111
1E111001100001111111
10000100001000100111
11010100101011101111
11011101001000100111
11000111011111001111
11110000000001000011
10001111011110011001
100000010G0010000011
10111001101100111111
11000011101110000011
11010000000000101011
11010111101110100111
11010101100010010111
11010100001011010001
10011111101000111001
101000000011100001A1
11101100100011111111
11111001111001111111
11111111111111111111