Level size: 12
Polisher percentage: 50
Starter line: 001110011101,
Whole Level:
11111111111111
1E011000111111
11001010010011
11101010111011
10001010001011
11100010110011
110110G0000111
11011001010111
11001011010001
11100000000111
11001011100111
100100001100A1
10110111110111
11111111111111