Level size: 24
Polisher percentage: 50
Starter line: 010011111001110111110100,
Whole Level:
11111111111111111111111111
111111111100111111111110E1
11000011001000000000001001
11111000011011101010100011
11000011000000001010011111
11111001010110111011000001
11000111010010100010010111
11010000011110101011010011
11010010101110101001001011
10011010100000101001011001
10001010101110001001011101
10101011000110101011000011
1010101000110G101001001111
11101011000110001011000001
11001001011110101001010101
10001101001000101010011101
11101101010001101010000111
11000101010101101011100111
11001101010100101000100001
11101001110100100101101111
11110010000110010100100011
11011011010010110111101001
11011011010010100001100011
11000001010110110100101011
11A11011011111110111111001
11111111111111111111111111