Level size: 8
Polisher percentage: 50
Starter line: 00101110,
Whole Level:
1111111111
10011110E1
1000000011
1100111011
1111G00011
1000001011
1010101011
1A10101011
1110111111
1111111111