Level size: 22
Polisher percentage: 50
Starter line: 1000101101001100010111,
Whole Level:
111111111111111111111111
111111111111111111111111
1110000000000000100000E1
111010100101011110111111
111010101101001010101011
111010111001101010101011
110110010110000010101011
110001110010101110000011
111100001010100101011111
100000100010110101000101
110011100111100101010101
11110000010G001101110001
100001010111100000010101
111111010000111110110111
110000011110100000000001
110101100000000011000001
110101001011110110000001
110111010000100110100001
110001000111101000100001
110110011100001001001001
100011000001101101011001
100100001101101001001011
1A1101101111101111111011
111111111111111111111111