Level size: 20
Polisher percentage: 50
Starter line: 01110101100010011100,
Whole Level:
1111111111111111111111
11111111111111111100E1
1101001000110101000101
1101011110100101010111
1100000110110001011011
1111010000100100000011
1000010111111100101111
1111110001000001110011
1100001011110100000011
1101011010011110111011
1101110001G00000001111
1100011011110010100011
1110111010000111101101
1000000011100011000001
1010111001101000111101
1011000001100010000011
1111100100001000111111
1100001100001110000011
1101000101000100101011
1A01001101010111100111
1111101101010011111111
1111111111111111111111