Level size: 20
Polisher percentage: 50
Starter line: 00001110100101110110,
Whole Level:
1111111111111111111111
1E00011111101111001001
1000100000100001000011
1000101111110111010111
1110000000110100010001
1110101111000101010111
1000110000011101010111
1110000101110001010001
1100011100000101010111
1101100011111101010111
110000110G000101011111
1101100100110111100111
1100010100010000001111
1101010101010110100001
1101010101011101111111
1101011101000000011011
1101000001100101001001
1101111111010101111001
1100000000010100000011
1110101101010101011111
111010011101110100A111
1111111111111111111111