Level size: 10
Polisher percentage: 50
Starter line: 1011000010,
Whole Level:
111111111111
1111000011E1
110001000101
110001010001
110101110101
11010G011101
110011000111
110111000011
110000100111
100110110011
1A1110111111
111111111111