Level size: 8
Polisher percentage: 50
Starter line: 00000000,
Whole Level:
1111111111
1E00000001
1000000001
1000000001
1000G00001
1000000001
1000000001
1000000001
10000000A1
1111111111