Level size: 22
Polisher percentage: 50
Starter line: 0000001110101011001100,
Whole Level:
111111111111111111111111
1000000111110001111100E1
100000000000011000000101
100000101111011010101111
100010100011000011101011
100010101001101000000011
111010111100101101110111
111010000010101100011111
100011011110100001000111
110001000100111101110011
110101101110000000001011
11010110001G011010101111
110101001011010011100111
110101101000111000010111
110100101010001001010111
110100101010101111011111
110110101010100000100111
110010101010101011101111
111010101011101000100001
100010101000000011001111
110010101110111111100011
100110101000000000001001
1A1110101101110011111011
111111111111111111111111