Level size: 14
Polisher percentage: 50
Starter line: 11010110010100,
Whole Level:
1111111111111111
11111111011000E1
1000100001001101
1000110101000011
1110000101010111
1100111110011111
1100011000000111
1101100G10111011
1100100110100011
1110000011101101
1110101000000001
1110101111111001
1000100100001011
1010000001100111
1A01101111111111
1111111111111111