Level size: 12
Polisher percentage: 50
Starter line: 010110101100,
Whole Level:
11111111111111
111111111100E1
11000000000101
11010101101111
11010101000001
110111G1000101
11000111010101
11010001010111
10000101010001
10010101010101
1A010101011101
11001001000111
11111011111111
11111111111111