Level size: 12
Polisher percentage: 50
Starter line: 011101101010,
Whole Level:
11111111111111
101111111100E1
10000110000111
11011100010011
11000001001111
11101101111111
100000G0011111
10001111000011
10000001011111
10001101000111
10001101010011
10000101111111
1A110100111111
11111111111111