Level size: 18
Polisher percentage: 50
Starter line: 001101001111111111,
Whole Level:
11111111111111111111
10011111111111111111
110000011000000010E1
11101100001011101001
11100101011010000011
11111110001010101111
11011000011110000001
11010011000001010111
11011101011011110001
11000001110000000111
111111000G0110110001
11010001111000000111
11011100101100110111
11000111101101000111
11101100000001110111
11100010111110000111
10001000000011110001
10101010101000000111
1A011010101111110111
11111111111111111111