Level size: 14
Polisher percentage: 50
Starter line: 11100110101001,
Whole Level:
1111111111111111
11111111110110E1
1000001000011011
1111001001001011
1100001101100011
1111100100001111
1100000001110001
11111100G0000101
1010011001111101
1000111000000111
1110000010100011
1000010110101011
1101010010111001
1101010100000011
11A1011101111011
1111111111111111