Level size: 20
Polisher percentage: 50
Starter line: 11001000110100100111,
Whole Level:
1111111111111111111111
1111111111111101111111
1E00000000000000000001
1010110011110111010111
1111011110010011010001
1100000000111110010111
1101010100000011001111
1101010101110111000001
1101010101000000010111
1001010101010101010011
1010010101G10101001011
1111010101110101101011
1101011110000100101101
1101100000110101100001
1101101100010111001101
1101100101100001001001
1100001000101011101101
1101010001101000101001
1101011101001000110011
1101001001101010010111
111001110010111111A111
1111111111111111111111