Level size: 12
Polisher percentage: 50
Starter line: 100110111001,
Whole Level:
11111111111111
11111101111111
11100000001111
1E001011100001
11101100001111
10110001000011
10101110001011
100000G0100111
11011110100011
11000000101001
11011110100011
11100000101A11
11101110111111
11111111111111