Level size: 16
Polisher percentage: 50
Starter line: 0001010011101011,
Whole Level:
111111111111111111
1E0000111111111111
100110111000000001
111000000011111001
111010011101110101
100011000000000111
111100010101111111
110101001100000111
1101010G0011100011
110101011000101011
110101011011101001
110111000000000011
110000010001010111
110101010101011111
110101010101000111
110101011100100111
11110100001111A111
111111111111111111