Level size: 22
Polisher percentage: 50
Starter line: 0011010111111000101000,
Whole Level:
111111111111111111111111
1E0111111111111111011111
110000000010100011011111
111011111110101001010111
100000010000101110000111
111101010101000011010111
100001110111101011010111
111100100110000001010111
100000101000111110011001
110010101010011000110001
111110101010110010000101
10110010101G000011010111
100001100000101011010111
111000000111111001010001
100001010000001111011001
111111011111000000000101
110000000110111011100111
110110110000000000110111
110100010111110100001111
110101010110010111100011
110101011100010011001111
110101000001001000100A11
110101101101111011101111
111111111111111111111111