Level size: 18
Polisher percentage: 50
Starter line: 010111001010101000,
Whole Level:
11111111111111111111
111111111110110000E1
11000101110000011001
11101000100101000101
10001011111101100101
11101000000100010101
10001101110101001111
11100100001101000001
110101011G0001110111
11010000011110000011
11000001001000111011
11010100000010001011
11010111000000101001
11010000110010101001
11010010011110101011
10010001000010100111
1A100011011110100011
11111010000110111111
11111011110110011111
11111111111111111111