Level size: 14
Polisher percentage: 50
Starter line: 11011100110111,
Whole Level:
1111111111111111
1111111111001111
10000001000000E1
1110011001010111
1011000011110001
1001101001100101
1101101100011101
1100000011000111
1111101G00010011
1101101011001111
1100001000100011
1101101010001111
1101001010110011
1101011010000111
1A01111011110111
1111111111111111