Level size: 10
Polisher percentage: 50
Starter line: 1010110111,
Whole Level:
111111111111
110001001111
1101000100E1
110111110111
110000000001
111011010111
101011G10111
100000110001
100010010111
100001010111
1A0111011111
111111111111