Level size: 8
Polisher percentage: 50
Starter line: 01110000,
Whole Level:
1111111111
10110000A1
1000010001
1101011001
1101000101
1101101101
1101000101
1101010111
1001110111
1111111111