Level size: 10
Polisher percentage: 50
Starter line: 1110010110,
Whole Level:
111111111111
1111111110A1
100011000011
110000010111
110111010111
100000010001
101001000111
101001010011
101010001111
101100100011
101111101111
111111111111