Level size: 16
Polisher percentage: 50
Starter line: 0010100110011101,
Whole Level:
111111111111111111
1A0001111100111111
101101100010000011
110100100110111111
110100110010000011
110110010010101011
100000111000110111
111100000000000111
101100B01111010111
100011000011010111
111000011010011111
100001000111000111
1111110101000H0011
110000011101001111
110111000001100011
110001011100100111
111011001110110111
111111111111111111