Level size: 8
Polisher percentage: 50
Starter line: 01000001,
Whole Level:
1111111111
111A000011
1110000011
1000101011
1110101001
1100100011
1000101011
1110101011
1110111001
1111111111