Level size: 10
Polisher percentage: 50
Starter line: 0101000111,
Whole Level:
111111111111
111011111111
1110110000A1
100011010111
100110010011
10B010001111
10H011011011
100000011001
100101000011
110010001111
111110100111
111111111111