Level size: 10
Polisher percentage: 50
Starter line: 0001011101,
Whole Level:
111111111111
1A0011111111
100010000011
111000111111
11110B000011
10000H011111
110010000011
111110111111
100000000011
110011101011
111111101001
111111111111