Level size: 12
Polisher percentage: 50
Starter line: 101101010001,
Whole Level:
11111111111111
11111110000A11
11000000110111
11100011011111
11011001001001
10000011011001
11110011000001
10000000011001
11001101000101
11111100011111
11000001000011
11010001011011
11011111111011
11111111111111