Level size: 12
Polisher percentage: 50
Starter line: 001011101011,
Whole Level:
11111111111111
1A011111111111
10000000000001
11000110110001
11110100110101
10000101000101
10101101011101
10100101000111
11110101101111
11000101100001
11010100110101
11010100010101
11011101110111
11111111111111