Level size: 14
Polisher percentage: 50
Starter line: 00011110000101,
Whole Level:
1111111111111111
1A00111000110001
1BH0000011000101
1001101011010111
1100100000010111
1101110101010111
1100010101010001
1101110111000111
1100100000101111
1101101100100001
1101001101111011
1101010000011011
1101011101001001
1101000101011001
1101111111011111
1111111111111111