Level size: 16
Polisher percentage: 50
Starter line: 1011010100100000,
Whole Level:
111111111111111111
1111111011000000A1
11000000110100BH01
110001000111010001
100010010000010001
101001110101000101
111110000101011111
110001110101000011
110100000101101011
110100111000101111
100110111011000001
100010010001011011
101010010001001011
101011010101011011
111001010101001111
111100100111100001
111111110011110111
111111111111111111