Level size: 14
Polisher percentage: 50
Starter line: 00010000000010,
Whole Level:
1111111111111111
1A000000BH000001
1000100000000101
1110101100010101
1110101110100111
1100100110100111
1001110100100011
1110000111101011
1110010011101011
1000010001001011
1010010111100011
1011010000100111
1100010010100001
1101010110100111
1111011100110111
1111111111111111