Level size: 8
Polisher percentage: 50
Starter line: 00001001,
Whole Level:
1111111111
1A00011111
1000000011
1001011111
1001000011
1100011011
1111010011
1000011111
1111001111
1111111111