Level size: 12
Polisher percentage: 50
Starter line: 111000110010,
Whole Level:
11111111111111
111000011110A1
10001010001011
11101011011011
11001000000011
10011111010111
11100000010001
11001111010111
11010000010111
10000111010001
11111011010111
10000000010001
11101111110101
11111111111111