Level size: 14
Polisher percentage: 50
Starter line: 10100100110000,
Whole Level:
1111111111111111
11A1101111000001
1101100000010B01
1100111110110001
1110000000100101
1000000H01001111
1110101001100011
1000101000101001
1111001010100011
1100011010101011
1110001011101011
1100010000101001
1111010110001001
1110010110100111
1111111110111111
1111111111111111