Level size: 14
Polisher percentage: 50
Starter line: 00001011011010,
Whole Level:
1111111111111111
1A00011110111111
10B0000000000111
10010010H0000011
1001011000001001
1101011010101011
1101100010101011
1110001110101011
1110110000101011
1111000101101011
1100001001001011
1101111101011011
1101110001010011
1100100101011111
1111111101001111
1111111111111111