Level size: 16
Polisher percentage: 50
Starter line: 1100101010101011,
Whole Level:
111111111111111111
111111101100111111
1000110000000000A1
10B010010101011001
110011110101000101
110001100101100101
110110001100010101
110010H00011001111
111000001011000001
110001111001010111
110100000101111011
111101010110000011
110001010000111011
111010011110000111
111010000000110111
100010110110010111
100011111111111111
111111111111111111