Level size: 8
Polisher percentage: 50
Starter line: 10110101,
Whole Level:
1111111111
11111110A1
1100001101
1101100001
1101000111
1000010111
1011100011
1001101011
1001101111
1111111111