Level size: 14
Polisher percentage: 50
Starter line: 00100111010101,
Whole Level:
1111111111111111
1A01111111110111
1001000000000011
1101110111101011
1100011000001011
1101101101111011
1000101001000011
1000000010001011
1001110100101011
1101110110100011
1100100100101011
1101111101101011
1101000000101001
1101010011101001
1111011011101111
1111111111111111