Level size: 10
Polisher percentage: 50
Starter line: 0000110001,
Whole Level:
111111111111
1A0001000111
10BH00010111
100011110001
111011101001
110000001101
100011100011
101011101111
110001000001
100011110111
101011110111
111111111111