Level size: 10
Polisher percentage: 50
Starter line: 1010000010,
Whole Level:
111111111111
1100000000A1
110110000101
110001010101
111011010111
111010010111
100010010001
101111010111
100100010111
101101010111
101111111111
111111111111