Level size: 10
Polisher percentage: 50
Starter line: 0100111011,
Whole Level:
111111111111
111111111111
11A110000011
110000B01001
110H01001101
111000111001
100001000011
111101101011
110110001011
110000101011
110101111001
111111111111