Level size: 14
Polisher percentage: 50
Starter line: 00111111000010,
Whole Level:
1111111111111111
10011111000011A1
1100001101110101
1110111001110001
1100000100000101
1000011101111101
1111000100000111
1100011101010111
1101000001010111
1101001111010001
1101101101000111
1000000000011111
1110101101110001
1000100000000111
1111101111111111
1111111111111111