Level size: 10
Polisher percentage: 50
Starter line: 0001101010,
Whole Level:
111111111111
1000111100A1
10B000000111
1001000H0011
110101001111
110111011001
110001101101
110100000001
100001011101
100101011111
101111011111
111111111111