Level size: 14
Polisher percentage: 50
Starter line: 01110100010011,
Whole Level:
1111111111111111
1A11111000111111
1001001001101011
11011010B0101011
1100000000000011
1111101111101011
1000000000101001
1100101010100011
1111101010011111
1000001011000001
1100011001010111
1111000101010011
10000H0111001111
1111100000011111
1111101111011111
1111111111111111