Level size: 10
Polisher percentage: 50
Starter line: 1010000011,
Whole Level:
111111111111
11A000000111
110110110011
110001101111
1110B0000011
111000111011
100010010011
10H011011111
100001000111
100101010011
110101111111
111111111111