Level size: 10
Polisher percentage: 50
Starter line: 0010100100,
Whole Level:
111111111111
1000011000A1
101101001101
110000011011
110101000011
110111011111
100000000111
110011010011
100100011011
100111001011
100111111011
111111111111