Level size: 16
Polisher percentage: 50
Starter line: 1101100001000110,
Whole Level:
111111111111111111
1111100001111110A1
111000111000110011
100010100010011011
110010101011001011
110111001000000011
110000000011110011
110111011000011001
110001110111000111
1101000000000B0011
110101111101001111
110101011011100011
110111000000001111
1100000110H0100001
110101001001111111
100101001100000011
101111111101111111
111111111111111111