Level size: 14
Polisher percentage: 50
Starter line: 01010110100000,
Whole Level:
1111111111111111
11100011110000A1
111011000100BH01
1000111010010001
1110001010111001
1101010000110101
1100010011000111
1101010000011111
1111010101000111
1110000101100111
1000001100010111
1000000011001111
1000010001000111
1001010101010111
1011111101111111
1111111111111111