Level size: 12
Polisher percentage: 50
Starter line: 100000010110,
Whole Level:
11111111111111
110B00001110A1
11000000000011
110101100H0111
11010111100001
11010001101001
11001111001001
11100000110011
10001010010111
11101010010111
10001011010111
11101001010111
10001111110111
11111111111111