Level size: 14
Polisher percentage: 50
Starter line: 11011100001100,
Whole Level:
1111111111111111
11111110000100A1
1010000110000101
1010110100111111
1011010000000011
1000010101111001
1101011100100011
1101001000001111
1101111001100001
1100110000001111
1110100101100011
1000001110101001
1110100000000011
1110111011111111
1111111011111111
1111111111111111