Level size: 12
Polisher percentage: 50
Starter line: 100110000000,
Whole Level:
11111111111111
111110000000A1
11100010BH0001
10001110000001
11000100100001
11001101100001
11100101001001
11111101011001
11000001011011
11011011010011
11010001011011
11010001001011
11011111111011
11111111111111