Level size: 8
Polisher percentage: 50
Starter line: 11100100,
Whole Level:
1111111111
11111110A1
1000100001
1110011011
1100110011
1000000011
1011101011
1001101011
1001101111
1111111111