Level size: 10
Polisher percentage: 50
Starter line: 1110110011,
Whole Level:
111111111111
111001110111
1000001100A1
111010000111
100011111111
110000000011
100011111001
101000000011
101000011011
101011001011
111111111111
111111111111