Level size: 12
Polisher percentage: 50
Starter line: 010010100010,
Whole Level:
11111111111111
1111001111A111
11000000010111
11010111000001
11010000111111
11010110000001
11010001110111
11010100000011
11010010111011
11010010001111
10011001011001
10000010000001
11111010111111
11111111111111