Level size: 12
Polisher percentage: 50
Starter line: 110011110000,
Whole Level:
11111111111111
11A00111000B01
110H0000010001
10000010110001
11101010100101
10001010101111
11101110100011
10000000101111
11100101100011
11110100101111
11000110101001
11010010100001
11100110110001
11111111111111