Level size: 16
Polisher percentage: 50
Starter line: 0000011100101101,
Whole Level:
111111111111111111
1A0BH0111111111111
100000000110000011
100001010000101111
100100111010110001
100110001010000111
110100101010010111
110101111011011111
110100001001000001
111101000111011001
100001011101010001
110110000001011001
110110101011000101
110100101000101111
110110101110100111
110100100011111111
111001110001111111
111111111111111111