Level size: 12
Polisher percentage: 50
Starter line: 011010010000,
Whole Level:
11111111111111
1A111110000001
10000000100B01
1H011011101001
10001001001001
10001011100011
11101000101111
11001011100001
11011010001111
10000010100001
11101110101011
11101000101011
11111111101111
11111111111111