Level size: 10
Polisher percentage: 50
Starter line: 1110100011,
Whole Level:
111111111111
111111111111
1A0001000011
111101011001
101100000011
100001011111
111011000011
111000111011
100010001111
100011100001
100001110111
111111111111