Level size: 8
Polisher percentage: 50
Starter line: 01000100,
Whole Level:
1111111111
11100010A1
1111011001
1000000011
1111111011
1000110011
1110000011
1000101011
1110101001
1111111111