Level size: 16
Polisher percentage: 50
Starter line: 1011000011110010,
Whole Level:
111111111111111111
1111000001111110A1
110001110011000011
111011000000101111
111101110110100011
111100000110001111
110000111101101011
111010010000001001
111010110111100001
111011101000001101
111100000000111001
110001111111000011
111000010000001011
110011111000101011
111110000010110011
111000011010100111
111011100011001111
111111111111111111