Level size: 12
Polisher percentage: 50
Starter line: 000000110101,
Whole Level:
11111111111111
100000011110A1
1BH00000001101
10000010100001
10001010101111
10001011100011
11101000101011
11101000101111
10001010100011
11101011100111
11001000101111
10001101101111
10101111111111
11111111111111