Level size: 14
Polisher percentage: 50
Starter line: 11110000100101,
Whole Level:
1111111111111111
11111000111110A1
1011001100011001
1000001101100011
1110101000001111
1100101011100001
1001000000011111
1100010001001011
1101110101110011
1101000100000011
1101110010101011
1100010010101011
1101011010101111
1101001010100011
1111111011110111
1111111111111111