Level size: 14
Polisher percentage: 50
Starter line: 10100010010010,
Whole Level:
1111111111111111
11A0000100110001
1101101000000111
1101100011011011
1101001011011011
1101001001100011
1101101100001111
1100101000100001
1111101100110111
1000000010010011
1100101011011011
1101101011001011
1101001000101011
1101000101110011
11011111011100G1
1111111111111111