Level size: 16
Polisher percentage: 50
Starter line: 1000110011100001,
Whole Level:
111111111111111111
111111000110001111
111000010000110111
1A0011110010110001
101100000110000111
111101010011110111
110001011000000011
111011100010111011
111010001010001011
100010110001011011
110010110010001101
110010001010111001
110001100010000011
110111101000101011
110100001110101001
1101010001001010G1
111101011111111111
111111111111111111