Level size: 18
Polisher percentage: 50
Starter line: 001101001011111100,
Whole Level:
11111111111111111111
1A011111011111110001
11000001000000000101
11101100001011110101
10000101111010011101
11111100011110000111
11000001000000111111
11011101111010000011
11000100000010101111
11011000101010100111
10001110101010010111
10010000101011111011
10010101101000000011
11010101001101011111
11010101100101000011
10011110000101011111
10001110101101000011
11100100100101101G11
11111111110000101111
11111111111111111111