Level size: 8
Polisher percentage: 50
Starter line: 01100100,
Whole Level:
1111111111
1A11111001
1000011001
1110011011
1000110011
1110000011
1000101011
11101010G1
1111111011
1111111111