Level size: 18
Polisher percentage: 50
Starter line: 100100011001011011,
Whole Level:
11111111111111111111
111A1111111111110111
11100011000001010111
10111001110101000001
10010100000101111001
11010001111100000001
11011100000000110001
11000111101010010101
11110000101011010111
10000010111011010111
10010010000001010001
11100111110101011001
11110101100101000101
10000100001101000101
11110110101101010101
11110010100000010111
11111110101011011111
11111000110001000001
111110100101111100G1
11111111111111111111