Level size: 16
Polisher percentage: 50
Starter line: 1111010100001100,
Whole Level:
111111111111111111
1111111000000100A1
100000001101000101
110001110001001111
111101000101100011
100001010100111001
111111010110000011
110000010010011011
110101110110001011
110100010010101011
110110111110101011
110010001000110011
110110110010010111
110100011010010111
110101100010111011
110101001010000011
11G110011011011111
111111111111111111