Level size: 20
Polisher percentage: 50
Starter line: 10001001000011110111,
Whole Level:
1111111111111111111111
1111111111111111111111
11111100001000000000A1
1101011110110000101111
1101000010000101100001
1101110010110100111111
1100000011010110100011
1101111001000000101011
1101100011111101111011
1100001000000000101011
1101111111110101101011
1100010000000100101011
1111111011001110101011
1000000111010110100011
1111110000010000100111
1000001111111110100011
1110100000000000000111
1000111110101011110111
1111011000101011000001
1100000001101010000001
11G1111101101110100001
1111111111111111111111