Level size: 8
Polisher percentage: 50
Starter line: 01111110,
Whole Level:
1111111111
11111110A1
1100011011
1101000011
1110000111
1000010001
1111010111
11G0000011
1111111001
1111111111