Level size: 10
Polisher percentage: 50
Starter line: 1111000110,
Whole Level:
111111111111
111100001111
1A1101000011
100001011111
111011000011
111000111011
100010001111
100011110001
101000000111
111010111101
1110100000G1
111111111111