Level size: 8
Polisher percentage: 50
Starter line: 01000010,
Whole Level:
1111111111
11100000A1
1110000101
1000010101
1111010111
1100000011
1101011001
11G1001011
1111111011
1111111111