Level size: 12
Polisher percentage: 50
Starter line: 010000110100,
Whole Level:
11111111111111
111111111110A1
11100000001001
11101010110011
11101100010111
11000001000011
10000111001011
11111001100111
11000101100011
11010000001001
11010101000011
10011110000111
1G001110110111
11111111111111