Level size: 16
Polisher percentage: 50
Starter line: 0111011100001100,
Whole Level:
111111111111111111
1011101100000100A1
100000000110000101
110110110110111111
110001010000000011
110101010101111111
110101011100100011
110101000010001111
110101011000100111
110101000111101111
110111010000000011
110000011101101111
110101000111000011
110101010001100111
110111101100100011
11G000000010101111
111011111110111111
111111111111111111