Level size: 20
Polisher percentage: 50
Starter line: 10011101010000111100,
Whole Level:
1111111111111111111111
11111111100000011100A1
1111110000110111000101
1111111111000101010111
1111101100010101000011
1111100101010101011001
1111110011010100011011
1111010000010111000011
1101010111110010011111
1101011100000110100011
1101000110100110001011
1101101110110000101011
1101100001011110111011
1100001101000000000111
1101010001110110110111
1111010100000010101111
1100010111101010101001
1110100101101000000001
1110101000001000000001
1000110010100010000001
1G00111110101111000001
1111111111111111111111