Level size: 10
Polisher percentage: 50
Starter line: 1100011100,
Whole Level:
111111111111
1100001100A1
110100000101
111101010111
110001010111
111011010001
100000110111
100011001111
100000000001
100011010111
1G0011111111
111111111111