Level size: 14
Polisher percentage: 50
Starter line: 01001111011001,
Whole Level:
1111111111111111
1111111110111111
11A0000000000111
1111101010010001
1100001011110111
1111111011011111
1100000000000001
1101101011011001
1101001000000101
1101011010111101
1101100010000101
1000001011110111
1010001000010111
1010101010010001
11111110111110G1
1111111111111111