Level size: 10
Polisher percentage: 50
Starter line: 1100011011,
Whole Level:
111111111111
111A00110111
110101010111
110101010111
110100000111
110000110001
110101010111
111101010111
110001010111
111011011101
1000000000G1
111111111111