Level size: 12
Polisher percentage: 50
Starter line: 000010011010,
Whole Level:
11111111111111
1A000111111111
10000000000111
10010100100011
10010010101001
11001010100011
11011110010011
11000001111011
11011100001011
110001011010G1
11101100011011
11100010111111
10000111111111
11111111111111