Level size: 20
Polisher percentage: 50
Starter line: 11011110111111111010,
Whole Level:
1111111111111111111111
11001111011111111100A1
1101000000000000000111
1101100101011101110001
1100111101010000000111
1110110101110101001111
1100000110000101110001
1101110010111100000101
1000000000011001111101
1110101110000000110101
1100100100110110000101
1001111101000110111101
1111000001010110000111
1101010101110100010111
1101011110000101010111
1101100000111101010111
1101101100010001010111
1101100101111011010001
1100001000100000100111
1001010010101100100111
1G11011110111100010111
1111111111111111111111