Level size: 8
Polisher percentage: 50
Starter line: 01100101,
Whole Level:
1111111111
1A11111001
1000011001
1111000011
1000011011
1010001011
1010101011
1100101011
11111110G1
1111111111