Level size: 20
Polisher percentage: 50
Starter line: 01011111010111100000,
Whole Level:
1111111111111111111111
11111111111111100000A1
1100000000000000100001
1111101011111101100001
1000001010110001001001
1010111110000101011001
1010010000101001011011
1111010101001010010011
1000011001011110111011
1011001010010000100011
1010001010100001110011
1100011100101010000011
1111010001101111101011
1110010100100001101011
1111110101110101001011
1100000101000101100011
1101101101011000101111
1101000101001011000001
1101101101110001011011
1101000100010010001011
11G1111111111010111011
1111111111111111111111