Level size: 10
Polisher percentage: 50
Starter line: 0110110110,
Whole Level:
111111111111
1A1101111001
100000000011
110101011111
110101100011
110100001001
110101100011
110101001011
110111011011
110000010G11
111011011111
111111111111