Level size: 14
Polisher percentage: 50
Starter line: 10000000000001,
Whole Level:
1111111111111111
1100000000000A11
1100000000000011
1101000000001011
1101000000001001
1101011000101011
1101011101101011
1101001101001011
1101001001001011
1101011011101011
1101010000101011
1001111010110011
1G00001000010111
1110101111010111
1111111111011111
1111111111111111