Level size: 16
Polisher percentage: 50
Starter line: 0110011110100101,
Whole Level:
111111111111111111
1A1000111111111111
100011000000111111
111000010010000011
100011011001011111
111011011111000111
100001001000110111
100011010010101111
100001100111101001
100001110000000001
100000000111110001
100010111011101001
111010000000001101
111010010110100011
100011010010100111
10100101101010G111
100111111011101111
111111111111111111