Level size: 10
Polisher percentage: 50
Starter line: 0000101010,
Whole Level:
111111111111
1A0001101111
100001000111
100100010111
101110110001
110100010111
110110110111
110001010111
110101010111
100100000001
1011100000G1
111111111111