Level size: 18
Polisher percentage: 50
Starter line: 101000101111101000,
Whole Level:
11111111111111111111
110111011111111100A1
11000000000000010001
11010101110101000101
11010101000100111111
11010101101110000011
11011101000100101011
11011001111111110111
11001111011000000111
11100000000011010001
10001101110001011001
10100100110100000101
11100101100110111111
11001100010010000011
11101001011010110001
10001011000110010011
11101001010111011111
11101111010001000111
111G0111011011010111
11111111111111111111