Level size: 18
Polisher percentage: 50
Starter line: 110101000001100010,
Whole Level:
11111111111111111111
111110111111111111A1
10001000000000110101
10011100101111000001
11000101101011011111
11011110101000010111
11011000000110010011
11010010110000110111
11011111010110000011
11000000000000101011
11111011111001101011
10000010110010001011
11101010000011101011
11001011110100001011
10010001000111101011
11100010011000001101
11110000110010100001
1G000100011010110111
11111101111110110111
11111111111111111111