Level size: 14
Polisher percentage: 50
Starter line: 10001011000011,
Whole Level:
1111111111111111
1111111100000111
111A000001111011
1110101011001001
1110110001011011
1110100100000011
1101111100101111
1100010110110001
1101010110100111
1101000000101111
1101011010101001
1101011010000001
1101100010000001
1110001000100001
11101110111100G1
1111111111111111