Level size: 10
Polisher percentage: 50
Starter line: 0001011000,
Whole Level:
111111111111
1000111100A1
100010001001
111000111001
111100001011
110110111011
110000000011
110110111011
110110001001
110100101001
1G0111101111
111111111111