Level size: 16
Polisher percentage: 50
Starter line: 1101111011001000,
Whole Level:
111111111111111111
111A11110111110001
110000000000110001
111110010010110101
110011111110000111
111000001100000011
110011100000111001
100010000010111011
101010111010010011
111010100011011011
100010100001011011
110010100101001001
110100100100011001
111100100101010011
111110110101011011
111100011101001011
111101001111111G11
111111111111111111