Level size: 14
Polisher percentage: 50
Starter line: 00110001011001,
Whole Level:
1111111111111111
1A01111111110111
1100000100010111
1101100001010001
1101101111010111
1101001000010111
1101111110010001
1100010000000111
1111010110010111
1000011100010011
1111000001001011
1100011101111011
11010000000110G1
1101001101000011
1001101101011111
1111111111111111