Level size: 12
Polisher percentage: 50
Starter line: 000001100111,
Whole Level:
11111111111111
10000010001111
100000001000A1
10000110101111
10010010100011
10011010101001
11001010100011
11011100010011
11000101111011
11011100001111
11000101101111
11101100111111
1G001110001111
11111111111111