Level size: 16
Polisher percentage: 50
Starter line: 0010100101001110,
Whole Level:
111111111111111111
1A0001111011111001
101100011011100011
110101011000001011
110101001011111011
110111010010001011
100000000110101111
110010110000100001
100010011001111111
101001100000000011
111110001010101111
100000101111100111
110010000111010111
110110100000010111
1101001010101100G1
110110101010010111
111110101011110111
111111111111111111