Level size: 8
Polisher percentage: 50
Starter line: 11000000,
Whole Level:
1111111111
11000000A1
1101000001
1101000001
1101010001
1101011001
1101000101
11G1111111
1111111111
1111111111