Level size: 10
Polisher percentage: 50
Starter line: 0010100111,
Whole Level:
111111111111
1A0001111111
101101110001
110000000101
110101101101
110110000111
100000100011
111010101011
100010101001
111010100011
111111101G11
111111111111