Level size: 12
Polisher percentage: 50
Starter line: 100110001100,
Whole Level:
11111111111111
111110000100E1
11100010000101
10001110111111
11000100000011
11011110101101
1000000A100001
11110101101101
11000101001001
11110101111101
11000100100011
11101110001111
111G1110100111
11111111111111