Level size: 24
Polisher percentage: 50
Starter line: 101001011110001001100000,
Whole Level:
11111111111111111111111111
11E11111111111111110000001
11011110011011000000100001
11001101010000011101100001
11101000000111110001001001
10101100100010000010011001
10001101001110101011010011
10010001110000101100011011
10011110001110100100001011
10000000100000111110101011
10011001110100010000100011
11101101000101110110101011
111000010110G1000100111001
11001011100011101110011011
11010010001010000011001011
11011011101011101001100011
11011000110000111010001011
11000101000100010010101001
11011101010101010100100011
11010001010101110100010111
11010111010100100101010001
11010010010111110001100111
11011110100000010100101111
11000100101010001101100001
111111111110101111010010A1
11111111111111111111111111