Level size: 18
Polisher percentage: 50
Starter line: 100100000001011100,
Whole Level:
11111111111111111111
111000000000111100E1
11101000000000000101
10111010001001110111
10000010001100000011
11011010101100111011
11001010000000001011
11101010101000011001
100010101G1011011101
11001010111111000011
11111010000001011111
10000010001000000011
11000110101010101111
11100010101011100011
10001011001001001011
11001011000101101011
11A01010001101101011
11100111101000101111
11111111101101111111
11111111111111111111