Level size: 18
Polisher percentage: 50
Starter line: 011100100010000101,
Whole Level:
11111111111111111111
101111111101110100E1
10000100110100000101
11010101100101010111
11011000100110010111
11000011110000111011
11111000000111000011
11000111010000011011
11010000011111001101
1101011011G000111001
11011000011011000011
10000010000011011111
11101010101011000111
10001010101000010011
11101110101011011011
10000000101001011011
10101101100101001001
10110000010101111001
1A111111011101111111
11111111111111111111