Level size: 18
Polisher percentage: 50
Starter line: 101100001000110010,
Whole Level:
11111111111111111111
111100001111111110E1
11000110000110000011
11001100010010111111
11010111011100000011
11110000000001110011
11001111011100011001
11010000000001000111
11010101010100111011
1101011101G110001011
11011000010100100011
11011010110100101011
11000010010110101011
11010011100010111001
10011011101000001101
10001001001101111001
10101001000100011011
1A101101010101100011
11111111011101101111
11111111111111111111