Level size: 14
Polisher percentage: 50
Starter line: 01011010111011,
Whole Level:
1111111111111111
1111111111111111
1100000000000E11
1101010101101001
1101010101101101
1101100011001101
1100010000000011
1110110110000111
1000010G10110001
1000110011010111
1000011001000011
1000011111011001
1000000000011011
1001001011110011
1A11011011111111
1111111111111111