Level size: 12
Polisher percentage: 50
Starter line: 110101110101,
Whole Level:
11111111111111
111111111110E1
10000001001101
10011011101001
111000A0000011
11001011101111
10001010000001
10101010101111
11101011000001
1G001010001011
11101011001011
11101001010011
11111111110111
11111111111111