Level size: 12
Polisher percentage: 50
Starter line: 010111001100,
Whole Level:
11111111111111
111111100100E1
11000000100101
11111100101111
11100000100011
1110101A101011
11101010100111
10011010001111
11000111101001
11110000000001
1G000101100001
11111000101001
11111111101101
11111111111111