Level size: 16
Polisher percentage: 50
Starter line: 1100001110011111,
Whole Level:
111111111111111111
111E00011100111111
110111001010011011
110111101011001001
110111001010010001
110000010010100111
111110010110101011
101100000G00000011
100001010111011111
110011010000000001
100100011111010111
100111100000010111
101000001011010001
111110101110010111
110100100011001111
1100011101000000A1
111111000111010111
111111111111111111