Level size: 22
Polisher percentage: 50
Starter line: 0010000111101011010000,
Whole Level:
111111111111111111111111
1E0111111111111111100001
100100000000000000000001
110001101010110101001001
110100101010110101011001
110111101010110101011011
110010001011100101100011
111000011100000100101111
100001010001110101000001
111101010100010101011011
110001010101G10101001011
110110010101010101101011
110100100101010100101111
110101111101010001000001
110101000001011101011011
100111011101011001001011
101000010001001011101011
110010110111101011101111
110010100010001001000001
111001101100011111110101
1111010001110000001101A1
111001111000001110001111
111111000011000111111111
111111111111111111111111