Level size: 16
Polisher percentage: 50
Starter line: 1101000110011000,
Whole Level:
111111111111111111
1111111110001000E1
100011000010001001
100000011000111101
101111000010011011
110000001000110011
110111101010000011
110010001G10101011
111110101011111001
100000101000000011
111010101011011011
110110101110001011
100000100000100111
111101110110100011
1A0000100010111001
111110110100000011
111110111101111011
111111111111111111