Level size: 12
Polisher percentage: 50
Starter line: 011110000010,
Whole Level:
11111111111111
1E111100001101
10000011010101
11010111000001
11010000010111
1001111A110011
10100000001111
11110010100011
11000111101101
11100011000001
110000000101G1
11100011010011
11101111011111
11111111111111