Level size: 10
Polisher percentage: 50
Starter line: 0010010000,
Whole Level:
111111111111
1001111000E1
100100000001
110111101001
110000001001
111000G10011
100001000111
111101010001
110001001011
111101101011
11A000111111
111111111111