Level size: 22
Polisher percentage: 50
Starter line: 1010100010111110010001,
Whole Level:
111111111111111111111111
110011110111111111111E11
110100000000011000001011
110101010111000010110001
110111010000111010011001
110000010110100111110001
110011110100110001110101
110100000111100100000101
111110010000001111111101
110011110010100000110111
110100000110111111000111
11010101011G000000011111
110101010100010001000111
110111010101010100101111
110110010101011100100001
110011110101000110001011
111000000101110001101011
110010110100001101001011
100100010010100101100111
111000110111110101100011
111100010001100100011001
1A0000110100101101000011
111110110111101101111111
111111111111111111111111