Level size: 14
Polisher percentage: 50
Starter line: 01101111010010,
Whole Level:
1111111111111111
1E11011111110001
1001000000010111
1101010101110011
1101111000000011
1000111011111011
1100000G11000011
1000110100010111
1010110101010111
1100010110010001
1000100010100111
1010101110100111
11101001001100A1
1110110100010111
1110010111011111
1111111111111111