Level size: 10
Polisher percentage: 50
Starter line: 0101110010,
Whole Level:
111111111111
1111111100E1
110001000111
111010011111
100000110011
111010A10111
100011000001
111100010111
110000010011
110101001011
11G110011111
111111111111