Level size: 14
Polisher percentage: 50
Starter line: 00101100000100,
Whole Level:
1111111111111111
1E01110000011001
1000000111001001
1100111101100011
1101000000001011
1101011111101011
1101010G00001011
1101010111111011
1101111000000011
1000000001011011
1110101101011011
1100101001001001
10011010011010A1
1110001100101011
1110111111101111
1111111111111111