Level size: 8
Polisher percentage: 50
Starter line: 00000010,
Whole Level:
1111111111
10000000E1
1000000111
1000010111
1000A10111
1001010111
1001010111
1101010111
11G1011111
1111111111