Level size: 8
Polisher percentage: 50
Starter line: 10010110,
Whole Level:
1111111111
11111110E1
1111100011
1011010111
1000G00001
1010010001
1010010101
1010110111
1A01111111
1111111111