Level size: 12
Polisher percentage: 50
Starter line: 101000111011,
Whole Level:
11111111111111
11E11111111111
11000110000011
11010000111001
11010010001101
10011001011101
10000111G00011
10110000111011
10110010010011
10000111111011
10110000001001
101000111110A1
11110001111111
11111111111111