Level size: 10
Polisher percentage: 50
Starter line: 0010100000,
Whole Level:
111111111111
1000010000E1
101101000001
110100010001
110000010001
110101A10101
111101010111
110001010111
111011010111
100001110111
1G0000011111
111111111111