Level size: 14
Polisher percentage: 50
Starter line: 01111111100110,
Whole Level:
1111111111111111
1E11111110001111
1000000010100011
1101110110001111
1111000000000001
1000110111110111
1110000A01010111
1000101110010001
1110100000111001
1000111010000101
1100011010100111
1101010010100011
1101010110111011
1101010110001G11
1101011100011111
1111111111111111