Level size: 22
Polisher percentage: 50
Starter line: 0011110101110011100011,
Whole Level:
111111111111111111111111
1E1111111111000110000111
100100000000010000100011
110101111111100010101001
110101010110001110100011
110101010100110001110111
110011000011000101000111
111000001110010101110111
110010100000110100000111
100110101111000111110001
1110001010G0001000000111
111010101111111010100111
100010100000000010101111
111010101001111010100011
100010110010000010101011
110100001000111010101011
110101100011100010101111
110101101110001011100011
110110001000110000010111
110010100111000011010111
111110101000011010011111
11111011110101101100A111
111110011111001001011111
111111111111111111111111