Level size: 10
Polisher percentage: 50
Starter line: 0110101010,
Whole Level:
111111111111
1E1111000001
100000000111
110011010111
100001010001
100111G00111
100000111011
101110000011
111100101111
110001000A11
111111011111
111111111111