Level size: 8
Polisher percentage: 50
Starter line: 00001110,
Whole Level:
1111111111
10000110E1
1000000011
10011A1011
1110001011
1110111011
1G00110011
1110100111
1110111111
1111111111