Level size: 16
Polisher percentage: 50
Starter line: 0000011111001101,
Whole Level:
111111111111111111
1E0000111110111111
100000011010110011
100010000000000011
100100111010011011
100111011011001111
110100011000111001
110101000010000001
11110100G011101001
100101010000101001
100011010111111011
100000010000000111
100101111011110111
110100100000011111
110100101010000111
110101111010110A11
111111111111111111
111111111111111111