Level size: 8
Polisher percentage: 50
Starter line: 11001000,
Whole Level:
1111111111
11111100E1
1000110001
1010110101
11100A0111
1100000011
1101011001
11G1001011
1111111011
1111111111