Level size: 10
Polisher percentage: 50
Starter line: 1010101101,
Whole Level:
111111111111
11E011111111
110000000011
110101110011
110100111001
110110G00111
110001110111
110100010011
100111000001
1000000110A1
111011011111
111111111111