Level size: 20
Polisher percentage: 50
Starter line: 11111111100100011111,
Whole Level:
1111111111111111111111
1111111111111111111111
1101000000000011011E11
1101011110101000001001
1100011010101111111001
1111000010111010000011
1000011110000010101111
1111000011111110100001
1000001000110010101111
1100101010000000100001
1111101011110011101111
1101101100G00000000011
1101000101110111101001
1101110001000000000011
1100000101010101110111
1111110101010100011111
1000000101010001000111
1010110111010101111111
1011000000010100000011
1100010011110110101011
11A1011011110010101111
1111111111111111111111