Level size: 20
Polisher percentage: 50
Starter line: 01100000011011111010,
Whole Level:
1111111111111111111111
1E00000000110111111111
1100100000000100000111
1101100001010101011111
1101001101011101000111
1101011001000001000111
1101110001011101010001
1100010101001101010111
1100110101010001110001
1001000111010100100101
1001100010G10101110101
1000101011110100010111
1000101000110111010111
1110101010100010010111
1110101100110111010001
1110100100010001010111
1000111101010101110111
1010011101010100010001
1110001001100010100111
1100011100100110110A11
1111011110110110011111
1111111111111111111111