Level size: 20
Polisher percentage: 50
Starter line: 01011110110110111011,
Whole Level:
1111111111111111111111
1111111111001111111111
1100010000000000100E11
1110110111010101101001
1000011101010110101101
1111001101010110101101
1000000101011000100011
1100110100001011101111
1111100110110000100011
1100001000010101101001
1101001111000110001101
1101010011G11100101101
1101011010000001110011
1101000011001110000011
1101111011000000011011
1100100000011111001011
1111101101000001011011
1000110001010101001001
1100011101010101101001
1001000001010101101011
1A11011111011100101111
1111111111111111111111