Level size: 16
Polisher percentage: 50
Starter line: 0111001110100100,
Whole Level:
111111111111111111
1111100111111000E1
110001000000101001
110100011101111011
110111000000010011
110001100110111011
111110001000001011
100000111010101001
100111000G11100001
111000011100001101
110111001101111001
110001111001000011
110100000011010111
110111010001010001
110001000011100111
111010011010000111
111A11111010110111
111111111111111111