Level size: 8
Polisher percentage: 50
Starter line: 11101001,
Whole Level:
1111111111
1111111E11
1000001011
1111011011
1000G00011
1100010111
1101010001
1001010111
1A01110111
1111111111