Level size: 24
Polisher percentage: 50
Starter line: 101011011100101101111001,
Whole Level:
11111111111111111111111111
11E00100111111110011111111
11010000010110000000001111
11011111100000110110100111
11000000001110110110101111
11001101100000010010110001
10000100100111011111000111
10001100110001001001000011
10000110100111111011011001
10000111000000000000011011
10000001101101111111100011
10001000001100000000001111
11101010110111111111100001
110010100000G0000110101111
10001001011101110000100001
10100101011101110111111111
11110101001000100000000011
11000101111101110101111001
11010100110010000100100011
11010110000011110110001111
11011100010000010010100001
11000101001110111010010111
11101101100010001011010011
10000111101011011011011111
10000000111111111111000A11
11111111111111111111111111