Level size: 16
Polisher percentage: 50
Starter line: 1111100000101110,
Whole Level:
111111111111111111
1111110001111110E1
110110101110000011
110000000000111011
110111101010010011
110010001010011111
111110101011001011
100000101000000011
110011101111010111
11110000A011011111
100001101000000111
111111001011101111
101100011100100001
100001000000001111
110101010101100011
100101010100010111
1G1111110101110111
111111111111111111