Level size: 10
Polisher percentage: 50
Starter line: 0011111101,
Whole Level:
111111111111
1E0111111111
110000100011
111010101111
11000A000001
100000110101
110100110101
110101000101
1101100011G1
110010100111
111111001111
111111111111