Level size: 14
Polisher percentage: 50
Starter line: 01010110101000,
Whole Level:
1111111111111111
11100011110100E1
1110110000010001
1000111011100101
1110001000001111
1101000011100001
1100001100011111
11011110A1000011
1100000001101011
1101010101101111
1101111110000001
1100000011001111
1101111011000001
11G0001000010111
1111111111111111
1111111111111111