Level size: 18
Polisher percentage: 50
Starter line: 111010111101011110,
Whole Level:
11111111111111111111
111111111111111110E1
10000000000000011011
11111111001111010011
11000000111011000111
11011110000000010111
11001000100010110001
11111010101010110101
10000010111011000101
1100100100G110001101
11011111010000100111
11010000010010000011
11011001010111000111
11001010010100010011
11111010110101110111
11011011100100010001
11000000001101100111
11A10101000100110011
11110111011110011111
11111111111111111111