Level size: 14
Polisher percentage: 50
Starter line: 10010111100100,
Whole Level:
1111111111111111
11E0111111111001
1101000000001001
1101011101101011
1101100000100011
1100000101111111
1101010100001111
11100101G1000001
1100111000111001
1110001010000101
1100101010111111
1001101010000011
1101001011101101
11010100010000A1
1111110111111111
1111111111111111