Level size: 10
Polisher percentage: 50
Starter line: 0110011010,
Whole Level:
111111111111
1011111100E1
100000000111
111110101011
100011101001
11000G000011
110111010111
100000010001
111101010111
100001010111
1A1111110111
111111111111