Level size: 8
Polisher percentage: 50
Starter line: 01000011,
Whole Level:
1111111111
111E000111
1110100011
1000101001
1100011011
100011A011
1010010011
1111111001
11111110G1
1111111111