Level size: 18
Polisher percentage: 50
Starter line: 111000001010001101,
Whole Level:
11111111111111111111
11100000110111111111
1E001110000000000011
11101100010101010111
10010001110101010111
10011110000101010111
10000011110101010111
10111000000101011111
11110011110111100111
110001000G0000001111
11111101110110100001
10110001000001111011
10000101110100011011
11111110000111001101
11100000110000111001
10001100010110000011
10101001110001011011
10001100000101001011
10101101111101111A11
11111111111111111111