Level size: 14
Polisher percentage: 50
Starter line: 00010101111111,
Whole Level:
1111111111111111
1E00000011111111
1001101000001011
1110011101111001
1111000000010011
1000010110011011
1111111G00001011
1101101101101001
1100000001100001
1101111010001101
1100100010010001
1111101010100111
1110001011110111
1100100001000A11
1111111111011111
1111111111111111