Level size: 16
Polisher percentage: 50
Starter line: 1101100001001000,
Whole Level:
111111111111111111
1111110001111100E1
111000110000010001
100010100011110101
111010110000000111
110110001010111111
110001000011000111
11011110G000010011
110110110011001111
110100000000100011
110111101110001111
110000000000100001
111110101010001111
1A0000101011100011
110011101000111001
111100001010000011
111101111001111011
111111111111111111