Level size: 16
Polisher percentage: 50
Starter line: 0110011101001011,
Whole Level:
111111111111111111
100000111111011111
1100100000010000E1
111110111111001001
100000000000011101
111010101111000011
110010100000111111
100110111010000011
111000001011101101
111010101A10000001
100010101011101101
111010101000100111
100010111011100011
101100000000101011
100101011101101111
101101000100011111
1G1111111101111111
111111111111111111