Level size: 24
Polisher percentage: 50
Starter line: 010111101000101011110000,
Whole Level:
11111111111111111111111111
111111111100010001110000E1
11000100010011010010010001
11100001110000011110111001
10000100010101100000000101
11110001110101101010111111
11000100000111001010000011
11010101110000001011101101
11010101000111100001000001
11010000010000110011111001
11010000110110010001101011
11010100110001010100001111
110101000101G1010111100001
11010101010101010000010111
11011101010010010110010111
11000101011111110001010011
11000101000001101011011111
11010101001110001011000111
11011001000110111010010011
11001111010110001010111111
11101100011100101010100011
11000100000001111111101101
10001110101000000010000001
1A101000101001101000111001
11101010101101100110011111
11111111111111111111111111