Level size: 14
Polisher percentage: 50
Starter line: 00000010000010,
Whole Level:
1111111111111111
1E00000000000001
1000000100000101
1000010101010101
1000110101010111
1001000101010111
1001011101011111
1101011A01000111
1101110011101111
1100010100000001
1110110101101101
1110100101100101
1000100101000111
1110110101010111
111111010101G111
1111111111111111