Level size: 20
Polisher percentage: 50
Starter line: 00110100110100100010,
Whole Level:
1111111111111111111111
10011111111111011100E1
1100000000000001110111
1110110101000100000001
1000010101010010101111
1111110101011110100001
1100010101001100111111
1101011101100011100011
1101000000001110001001
1101010101100000101001
1101010100G10111100111
1111010101010011010111
1000010110000110010111
1101100010010000110001
1101101111010100010111
1101000001010101100111
1101011101010100100011
1101011001010111101011
1101010010010001101011
1001010100011101001011
1A11111111001101111111
1111111111111111111111