Level size: 12
Polisher percentage: 50
Starter line: 110111011100,
Whole Level:
11111111111111
111111101100E1
11100000000101
11101111110111
11110000010111
11010111010111
110110G0000001
11000001000001
11010101010001
11110101011001
11000101000101
11101101101111
1A000011101111
11111111111111