Level size: 14
Polisher percentage: 50
Starter line: 00101110111111,
Whole Level:
1111111111111111
1E01111111111111
1000000000000011
1100111101011011
1111100001010011
1000001111010111
1110101A00010001
1000111101010111
1100010001001111
1000100001000001
1010101011100111
1110101000100011
1000101100101011
1110100101001G11
1111110110011111
1111111111111111