Level size: 14
Polisher percentage: 50
Starter line: 00001001000011,
Whole Level:
1111111111111111
1E00011111111111
1000000000000011
1001011110101001
1001000010100011
1100011010101011
1110001100101011
10000001A1001011
1101010111011111
1101000001000001
1101011111010111
1101000011010001
1101011010011111
11010010010000G1
1111111111011111
1111111111111111