Level size: 12
Polisher percentage: 50
Starter line: 100000010111,
Whole Level:
11111111111111
11E00000111111
11000000000001
11010110011111
11010010000011
11011010101011
1100111G101011
11100100110011
10000110010111
10110010010111
10100011110011
11001000001A11
11111111101111
11111111111111