Level size: 20
Polisher percentage: 50
Starter line: 10011000110110111011,
Whole Level:
1111111111111111111111
1111110001101111111111
1110001000101100100011
1E00110011101000101001
1110010000001010001101
1100110101111110101101
1000010110000000100011
1111010000111110101011
1100000010000010101011
1101000011111010111001
1101010001101010001101
1101010100G01111111101
1101010111100000000011
1101010011010101001011
1101011000010111101011
1101001011010000101011
1101101011011010110011
1100101011001010010111
1110101000100111110111
1000111010100000000111
11100110111111111100A1
1111111111111111111111