Level size: 16
Polisher percentage: 50
Starter line: 1001001111100111,
Whole Level:
111111111111111111
111E11111110001111
111000001100100001
101110100001101111
100110111100000011
110000100001011001
110101111101000011
100110110001101011
101000000G00101011
111010011010101111
100011001010100001
110001011010110111
110101010010000111
111001010100100011
110011110110101011
111010000010101A11
111111111110101111
111111111111111111