Level size: 16
Polisher percentage: 50
Starter line: 1111000000011011,
Whole Level:
111111111111111111
111100000000110111
1E0001000000000111
110011000001010111
111010010101010111
100011110101011111
101100000101000111
111110101001101111
110000101A00100001
111110101110110101
100000100010010101
110001110111010111
111001000001010111
100010010101010001
111010110101011001
1000101001010001G1
111110111101101111
111111111111111111