Level size: 14
Polisher percentage: 50
Starter line: 00100010101010,
Whole Level:
1111111111111111
1E01110000110111
1001011100000111
1100011001010111
1101110001011111
1100000101100111
1110110101000111
1000001A01010111
1000011011010111
1000001100010111
1000001110110111
1000000000010111
1000010110010111
1001010001010111
101111010101G111
1111111111111111