Level size: 24
Polisher percentage: 50
Starter line: 010100101010110001101001,
Whole Level:
11111111111111111111111111
11101100001111000011111111
11001111000000010000000E11
11000110010111110111101111
11011000110001010000100011
11001010001101010111111011
11100000101111010000101011
11000111110000000110101001
11010001000111011011001101
11110101010000111000001101
11000101011110011010100011
11001101001101110010101011
10000101100000000110101011
100111101011G0111010101011
10000010101100000011101011
10001010100011111110001011
11101110101000001101111011
11100000001110100000001011
11101111100001100111100111
11101100011100111000011111
11001101100010001011000111
10000001101010111000111111
10011100001010000010000001
10000011011011101000110111
1A001011111111101011111111
11111111111111111111111111