Level size: 12
Polisher percentage: 50
Starter line: 110111110011,
Whole Level:
11111111111111
11E01111101111
11010000100001
11011010000111
11000011101111
1110100G100001
11100011001111
10001011100011
11101000001001
10001101100011
11000100101111
110101011000A1
11011100111111
11111111111111