Level size: 12
Polisher percentage: 50
Starter line: 010001110110,
Whole Level:
11111111111111
111111110010E1
11101101000001
10000001010101
11111100011101
11011000000111
1100001G110011
11011110001011
11001000101101
11111010100001
10000010011101
11101010000111
1A000111111111
11111111111111