Level size: 8
Polisher percentage: 50
Starter line: 00010101,
Whole Level:
1111111111
1E00110111
1000100011
1110G01011
1111111011
1000110011
1110000011
1000101011
11101010A1
1111111111