Level size: 8
Polisher percentage: 50
Starter line: 01000100,
Whole Level:
1111111111
11100010E1
1111011001
1000A00011
1111111011
1000110011
1110000011
1G00101011
1110101001
1111111111