Level size: 18
Polisher percentage: 50
Starter line: 111010000111000000,
Whole Level:
11111111111111111111
111111111111000000E1
10000000110001000001
11111010110101100001
11000110000100010001
11010001111110110001
11010100011000000101
11010110000011110111
11011000111011000001
1101001000G010000001
11011110111000100001
11010000100011100001
11010111001001001001
11011000011111011001
11010011010000010011
11011110010101011011
11A01000110101001011
11111010100101101011
11111011001100101111
11111111111111111111