Level size: 16
Polisher percentage: 50
Starter line: 1100010110001110,
Whole Level:
111111111111111111
1100111111000110E1
110111000010000011
110100011110101011
110001100010101011
111000001011101011
101101111100001011
100000001101111011
110011111G00001011
110001100011100111
110110001000011111
110010111111100111
111000000110001111
111011010000100001
100011010111111111
100000100000000011
1A0001101111111111
111111111111111111