Level size: 8
Polisher percentage: 50
Starter line: 01101000,
Whole Level:
1111111111
1E11110001
1000000001
11011G0101
1000111101
1000011001
1001001101
11001110A1
1111111111
1111111111