Level size: 22
Polisher percentage: 50
Starter line: 1011010000010000011101,
Whole Level:
111111111111111111111111
111111100000000000111111
110000000001101111010E11
111110001010001101011011
100010111010100001000011
101011100010101110010011
111001101110100010110111
110011010000101110000011
100000010111100101101101
111111010100110100000001
110100011100000111101101
110111000001010000000111
110000010011G10110100011
110101010100011000101011
110101010111100010101001
110111011000001100100011
110001100011110001110111
110110001010110101000111
100011011110000101110111
100100010000111110000111
101101010111011000110001
110001111000010010010111
11A100111011000111110111
111111111111111111111111