Level size: 14
Polisher percentage: 50
Starter line: 01010011101101,
Whole Level:
1111111111111111
111E111111111111
1110111000110011
1000010011100011
1110010000101011
1000010011001001
11110000A1000001
1100110011010101
1101000100011101
1100010101000111
1101011001111111
1101001000000001
1101111010111111
11000000100000G1
1111111011110111
1111111111111111