Level size: 14
Polisher percentage: 50
Starter line: 01101111101000,
Whole Level:
1111111111111111
1A11011111110001
1000000000010001
1101010101000101
1101110100111111
1000000110000011
1010111100101011
1010000001100111
1110100100000011
1011001111101011
1001101011101011
1100001000001111
1101111011100011
1100010000100111
111111111111G111
1111111111111111