Level size: 10
Polisher percentage: 50
Starter line: 0110000100,
Whole Level:
111111111111
1A1000011001
100011101001
110001101011
110110001011
110110111011
110110000011
110000011011
110101011001
1101010010G1
110111111111
111111111111