Level size: 22
Polisher percentage: 50
Starter line: 1100011100111011010011,
Whole Level:
111111111111111111111111
111A00111001111111111111
111101000100000000010001
111101010001111011010111
110001011100000011010111
111011100111111001010111
111010100010110101010001
100010101010100111010111
110000011000010010010111
110111000001110111010011
111000010100000101001011
110011110111110101011011
110100000100010101000011
111110011011010001111011
110010110000001010101011
111010110110100010001011
111011100111110010000011
110010011100000110111011
100000110001010001100001
111100000100110101110001
110001110101000100000001
110101000101010100000001
1111111111110111010000G1
111111111111111111111111