Level size: 20
Polisher percentage: 50
Starter line: 11111011101100101001,
Whole Level:
1111111111111111111111
1111100110011011011111
11A0000000001011000111
1101001110101000010111
1101000010110011010011
1101011110010110111111
1101000011110000001011
1101111000110101110011
1100001000000100000011
1110101111100100011011
1000100000010101001011
1100101010011101001001
1111101010000101101101
1000001010111110101001
1100011010000000101101
1111010011010111100011
1000011001010000011111
1011001001010101000001
1010001101010101011001
11001001010101010001G1
1111111101110101101111
1111111111111111111111