Level size: 16
Polisher percentage: 50
Starter line: 0110001111000100,
Whole Level:
111111111111111111
1A0000011111111001
110010001101101001
111110100000000011
100000111011101011
110010000000101011
111000111010101111
100011000011100001
111101111000011111
110000011011000011
111101000000101011
110011111010101011
111000111010101011
110010000010111001
100010111010000011
111010001010111011
111111111011111G11
111111111111111111