Level size: 14
Polisher percentage: 50
Starter line: 00110100100101,
Whole Level:
1111111111111111
1A01111101111001
1100000000011001
1110110101100011
1000010101101111
1111110100000001
1100000101100101
1101100111010101
1100100000010111
1101101001110001
1101001100100111
1101000110111111
1101110100000111
1100010110110G11
1110110010111111
1111111111111111