Level size: 10
Polisher percentage: 50
Starter line: 0101010011,
Whole Level:
111111111111
111001111111
1110001100A1
111010000111
100011110111
110011011111
111000000001
110011011001
100000000101
111011100111
1G0000110111
111111111111