Level size: 14
Polisher percentage: 50
Starter line: 11110111111010,
Whole Level:
1111111111111111
11111011111100A1
1000000000000111
1100101010110001
1111101010000111
1000001111111111
1100000000000001
1110000101010111
1000010101010111
1101001111010001
1101100000111001
1101101110000101
1101000100111111
11G1110110000011
1111110111111111
1111111111111111