Level size: 20
Polisher percentage: 50
Starter line: 00111010100100000100,
Whole Level:
1111111111111111111111
1A01111101100000000001
1100100101101000001001
1110101100111010101011
1100001010000010101011
1111101000111110101011
1100001010000000101011
1110101011110101101011
1110101110000101001011
1100100001110101111011
1001111000000100110011
1110111010101110000111
1100000010100010110001
1101111010110110010111
1000000010010011010011
1111010111010100011001
1100010111010101000011
1110010010010111011011
1100111011100001010G11
1110001000101010010111
1111111111101011111111
1111111111111111111111