Level size: 18
Polisher percentage: 50
Starter line: 001000010111001101,
Whole Level:
11111111111111111111
10000000111111111111
10110001100001000A11
11000110001110010111
11010010100000111011
11010000001010000011
11010111011011011011
11010100000001001001
10011101010101101001
10100001010000100011
11110101010010111011
11000010011010001011
11011110001010111011
11010000101010001011
11010101101010101011
11110100101011101111
1G000101001001001111
11101101011011111111
11100101111000111111
11111111111111111111