Level size: 20
Polisher percentage: 50
Starter line: 00100101111110011010,
Whole Level:
1111111111111111111111
1A01111111111111110001
1001000000101000000111
1101110101101010100011
1100101100000010101001
1101101001011110100011
1101101111000000001111
1101001101010101111011
1101101001010000001001
1100001100011111100011
1111101100000000011111
1000000101011111000011
1100110011000000011011
1111000000001111001011
1101010101011000101011
1101011101000010101001
1101001101011110101011
1101111011000010101011
1100000000011110111011
1111100110000010000G11
1111110110111011111111
1111111111111111111111