Level size: 12
Polisher percentage: 50
Starter line: 011100011111,
Whole Level:
11111111111111
1A110000111111
10000100011111
11010101001101
11010101111001
11010100100011
11010110001111
11010000110001
11011111000111
11000000000011
11101011111001
10001000000011
11101011111G11
11111111111111