Level size: 10
Polisher percentage: 50
Starter line: 0110110000,
Whole Level:
111111111111
1111110000A1
110110010001
110000011001
110101011101
111101011111
110001011111
111011011111
100000111111
100000001111
1G0000000111
111111111111