Level size: 20
Polisher percentage: 50
Starter line: 00010011111010101100,
Whole Level:
1111111111111111111111
11111111111111000100A1
1111100011000101100101
1110111001011001101111
1100000011001011000001
1101010001011010001111
1111100101010010010001
1100001101000111000111
1111110101110101010111
1011000000010100011001
1000111110100000110001
1110000000101010000101
1100101010111011110111
1001110000000000110111
1111010101111010010001
1100010111000011111001
1101000000001001110101
1101111001101000000101
1101101001001000110101
11G0100011101010010111
1111111111101111110111
1111111111111111111111