Level size: 16
Polisher percentage: 50
Starter line: 0110111010110110,
Whole Level:
111111111111111111
1A1111111111111111
100000000000000011
110100111111100111
110110001101100011
100000010001101001
111010000100111011
100010111100000011
110010110001011011
110100000111011011
100001010010001101
111101010010000001
100001011010101011
110110001010100111
110110110010100G11
110100010100111111
110110111100011111
111111111111111111