Level size: 8
Polisher percentage: 50
Starter line: 11011011,
Whole Level:
1111111111
1110110111
1A00000001
1000000001
1000000001
1000000001
1000000001
1000000001
10000000G1
1111111111