Level size: 10
Polisher percentage: 50
Starter line: 0000011101,
Whole Level:
111111111111
1A0000111111
100000000011
100001011111
100101000111
100101010011
110101111111
110100000011
110111111011
110010010G11
111111000111
111111111111