Level size: 16
Polisher percentage: 50
Starter line: 1100001011110110,
Whole Level:
111111111111111111
11A011111111101001
110000000000000011
110101011110101011
110101000011111011
110101011001110111
110111000100000111
110000110100110001
110110010110100111
110110010001100011
110011110100001011
111000110101111001
110010001110000011
100010100000101011
111010111111101011
111010000000101011
111111110100011G11
111111111111111111