Level size: 14
Polisher percentage: 50
Starter line: 11001111011111,
Whole Level:
1111111111111111
11A0011110111111
1101000010000011
1000001010101101
1110101110100001
1000100000101101
1110101111101001
1100100011001101
1001101010001001
1110001010100111
1110101111111111
1100100000000011
1001101100101011
1110000010101011
11101010101010G1
1111111111111111