Level size: 14
Polisher percentage: 50
Starter line: 11101000101101,
Whole Level:
1111111111111111
1111111101111111
1A00000100000011
1111010000111011
1011011001101011
1000111000001011
1110000010101011
1000010110101011
1101010010111001
1101010010011011
1101011000110011
1101001010000011
1101001000101011
1101001110101G11
1111100110101111
1111111111111111