Level size: 20
Polisher percentage: 50
Starter line: 00001010101000101110,
Whole Level:
1111111111111111111111
1A00010011011101111001
1000010000000000000011
1001000101010101111011
1001010101110100010011
1101010100010101011111
1101110100011101000111
1100010101000010010011
1110110111101011111111
1000010000100000000011
1010010000110101010001
1011010110110011010011
1110010110010110111111
1100111100010000001011
1110000101010101110011
1000111101010100000011
1010001001010111011011
1110101011010001001111
1100101010011101111001
11111010110001000000G1
1111101001011111101111
1111111111111111111111