Level size: 18
Polisher percentage: 50
Starter line: 011010001101101011,
Whole Level:
11111111111111111111
1A111111111011111111
10000110100000011111
11010000111011111111
10001111001001000111
10000001101101010111
10011110100100010111
11000010101101010111
11011110100001010111
11000100001101010111
11101101111011000011
10000101000000011001
11100000001011000011
10001000101000111011
11101111101010001011
10000000101010110011
10001100101110010111
10000110100001111111
100001110011000G1111
11111111111111111111