Level size: 20
Polisher percentage: 50
Starter line: 01010011111110101011,
Whole Level:
1111111111111111111111
1110111111111111000111
11101110000100000110A1
1010010010110111010001
1010011110100000000101
1010010010100110101111
1001010110000010110001
1101000001100111000111
1101010101000000000011
1101111000011111111001
1000000011000000011011
1111011110010111000011
1100010000110001011111
1101010100011101000001
1101010101000101001111
1101010101001101000001
1001010100101101110111
1010010101100000000011
1111010100011000101011
1000010111011010101011
1G11110111011010101111
1111111111111111111111