Level size: 18
Polisher percentage: 50
Starter line: 100011000000001101,
Whole Level:
11111111111111111111
11111100000000011111
11100001000000000011
1A001111000000101011
10110111011010101011
11100000011010101001
11000110001010101101
11110110100010101001
10000010101011101011
10101110110001001011
10101000010101011011
11101011010101010011
10001001010111010111
11001111010010010111
11000100010111010011
11011001010100011011
11001101010100001011
11101101010110101G11
11111101110011101111
11111111111111111111