Level size: 14
Polisher percentage: 50
Starter line: 00011111000001,
Whole Level:
1111111111111111
1A00111100000111
1000011101110011
1001000000011011
1100011101011001
1111011101000011
1000001001011111
1010111101000011
1010000101010011
1111010101010111
1000010111010001
1101100001100111
1101101000101111
1101001010101111
11011110111G1111
1111111111111111