Level size: 16
Polisher percentage: 50
Starter line: 1101100011001111,
Whole Level:
111111111111111111
111110000100011111
111000101001000A11
111010101111001011
111010100101100111
110110101001100011
110010111010101001
111010000010100011
100011111010001111
111000001011100011
110001011000101101
110101100110000001
110100101110000111
110110001100101111
110100100111101001
110100110000000001
1G0110110111110001
111111111111111111