Level size: 16
Polisher percentage: 50
Starter line: 0001100001100100,
Whole Level:
111111111111111111
1000000000111110A1
100100010000011001
100101010111011011
110101010001000011
110101010101001011
111101010101111011
100001010100001001
111101010101000011
100001110101011111
111100000101000111
110001100111010011
110100100001111011
110101101000001011
110110001110101111
1G0000100001100011
111101111111111111
111111111111111111