Level size: 16
Polisher percentage: 50
Starter line: 1011001111110111,
Whole Level:
111111111111111111
111111111111001111
1100000010100000A1
111010100010101111
100011100000000001
111100111101111111
110110000000000011
110000010100011011
110101011001001011
111101100011100111
110001101000001111
111110001011100111
110000001000010011
111010101010001111
111010101010100011
101010111010010111
1G0010011011110111
111111111111111111