Level size: 16
Polisher percentage: 50
Starter line: 0000100000001101,
Whole Level:
111111111111111111
1A0000000000011111
100001000000000011
100101010110101011
101101010110101011
110001010010111001
111111010010001101
100000011001011001
101001001010001011
101100101010111011
110111101010010011
110110001011111011
110000110000001011
1101000100101110G1
110101111010000011
110100001011011111
111001101001011111
111111111111111111