Level size: 20
Polisher percentage: 50
Starter line: 11110000110110010100,
Whole Level:
1111111111111111111111
11110000011111011000A1
1111011000110101001101
1100001010000101000011
1110101110101101010111
1110100100101000011111
1001101111101010000111
1100000001101010111111
1100111101001110101011
1101101100100000101011
1000000001101101100011
1110101100000000101111
1000110001011010001001
1111000101001001000001
1101010101011100010001
1101110101010001010001
1100000001010001010101
1101011011100101000111
1101010010001001000011
1001111010101011010111
1G00111111111011010111
1111111111111111111111