Level size: 10
Polisher percentage: 50
Starter line: 1011000111,
Whole Level:
111111111111
111100001111
11A001000001
111011010111
111010010111
101010110001
101111000111
100000010111
101101010111
110001010001
1101110101G1
111111111111