Level size: 8
Polisher percentage: 50
Starter line: 00010011,
Whole Level:
1111111111
1A00111111
1000000011
1100100111
1100010111
1101000011
1101111001
1100000011
1111111G11
1111111111