Level size: 10
Polisher percentage: 50
Starter line: 0011011000,
Whole Level:
111111111111
1A0111100001
110011001001
111000001001
100010101011
111010101011
110010101011
100110101011
111100101011
110001101011
111111101G11
111111111111