Level size: 8
Polisher percentage: 50
Starter line: 00110000,
Whole Level:
1111111111
1A00000001
1110010001
1111010001
1100010101
1101110101
11000101G1
1111100111
1111111111
1111111111