Level size: 8
Polisher percentage: 50
Starter line: 01110011,
Whole Level:
1111111111
1A11001111
1000010001
1101000111
1101111111
1101100001
1100000101
10010101G1
1011010111
1111111111