Level size: 12
Polisher percentage: 50
Starter line: 111101001000,
Whole Level:
11111111111111
111111110000A1
11100001010001
11001011110101
11111000000101
10000001101101
11101110000111
10000001100011
11101100001011
11110001011001
11110101000011
11G00101111011
11101100111011
11111111111111