Level size: 8
Polisher percentage: 50
Starter line: 00000100,
Whole Level:
1111111111
1A00000001
1000001001
1000101011
1001101011
1110001011
1110111011
1110010G11
1111111111
1111111111