Level size: 8
Polisher percentage: 50
Starter line: 00011111,
Whole Level:
1111111111
1A00111111
1000011001
1011001101
1100011001
1110000011
1000001011
1111101011
1111111G11
1111111111