Level size: 10
Polisher percentage: 50
Starter line: 0011100001,
Whole Level:
111111111111
1A0111000111
110000110111
111010110001
111010000111
100111110111
110011010111
110000000001
100010010001
1010101001G1
111011001111
111111111111