Level size: 10
Polisher percentage: 50
Starter line: 1101101101,
Whole Level:
111111111111
111011011111
100000000A11
100000000011
100000001011
100000001111
100000101111
100001101111
100010001111
100011011111
1G1011111111
111111111111