Level size: 10
Polisher percentage: 50
Starter line: 1010011010,
Whole Level:
111111111111
11A111111111
110110000111
110000100011
111110101001
111000100011
110011110111
111100000001
100000011001
111010010001
1110110101G1
111111111111