Level size: 8
Polisher percentage: 50
Starter line: 11000011,
Whole Level:
1111111111
11A0000111
1101110011
1100001001
1101111011
1100100011
1110001111
10001000G1
1111110111
1111111111