Level size: 14
Polisher percentage: 50
Starter line: 01000101101100,
Whole Level:
1111111111111111
111A001111111111
1110010000011111
1000100110001111
1110100100110111
1000110001100111
1110010100000011
1100010111101011
1101010001101011
1101110011001111
1100000000100011
1110110110001111
1000010010000111
100000011101G111
1000001111111111
1111111111111111