Level size: 12
Polisher percentage: 50
Starter line: 100000011011,
Whole Level:
11111111111111
11A00000110111
11000000000111
11010101010111
11010101010111
11011101011111
11000110000111
11010010101111
10001010100001
10011010101011
11000010101001
110110101010G1
11111011101111
11111111111111