Level size: 14
Polisher percentage: 50
Starter line: 11111101110001,
Whole Level:
1111111111111111
1111111111111111
11E0000000000111
1101101011010111
1101001000110001
1101011010000111
1101100011111011
10000010A0000011
1010111101111001
1010010000000011
1111010010111011
1000011010001011
1010001000101101
10101010101000G1
1110111010111111
1111111111111111