Level size: 20
Polisher percentage: 50
Starter line: 10110010011111100111,
Whole Level:
1111111111111111111111
1111101111111110001111
11000000000000001100E1
1110101111001110000111
1100100100000011010011
1001111101011111011001
1110110001000000000011
1100000101010101101011
1101110101010101101011
1000001101011101101011
1110100001G00000111011
1000101001011010000111
1111001001001010110011
1101111011011010001011
1100000001001010111001
1101010101111010000011
1101010100100011011011
1001100101000001001011
1A00101001010100111001
1110101011010100000011
1111111110011111011111
1111111111111111111111