Level size: 10
Polisher percentage: 50
Starter line: 0010011000,
Whole Level:
111111111111
1E0111100001
100100001001
110111011001
11000G011011
110101100011
110101101011
110100101011
110011101001
111100001101
1111111011A1
111111111111