Level size: 12
Polisher percentage: 50
Starter line: 000001110101,
Whole Level:
11111111111111
100000111110E1
10000000001101
10000101111001
10010100000011
10010101011111
110101G1000111
11010101010111
11011101011111
11001001000111
11011011101111
10010000100111
1A011111111111
11111111111111