Level size: 14
Polisher percentage: 50
Starter line: 00001101010110,
Whole Level:
1111111111111111
1E00011111001001
1000000010100011
1001111010001111
1110000011101001
1110101010000001
1111001000000001
1111001A00000001
1111101010000001
1111101011000001
1100001000100001
1111011101100001
1110001000101001
11111111011010G1
1111111111111011
1111111111111111