Level size: 22
Polisher percentage: 50
Starter line: 0001011101111110100111,
Whole Level:
111111111111111111111111
1E0011111111111111111111
100010010000000000110111
111000111010101110100111
111010101010100010110111
100010101010010001010111
110010000000110011010111
110111111010100000010111
110001100000001111110001
110111001111100000010111
110000011000101110110111
11111000001G100011100111
101001100111011000100011
100011000000000011111011
111000011111011001000011
100011000001001011011111
111100010101011000000011
110110110101001010111111
110000010101111010100011
110110110101000011101101
110110010111011100000001
1101001000000000011110A1
100111101111011100111111
111111111111111111111111