Level size: 10
Polisher percentage: 50
Starter line: 1110001111,
Whole Level:
111111111111
111E00011111
111010100011
111010101011
111010111011
100110A01001
110000010001
110111000001
110000010001
110101010001
1111011101G1
111111111111