Level size: 12
Polisher percentage: 50
Starter line: 100110000111,
Whole Level:
11111111111111
11111000001111
111000010000E1
10001101010111
11000111011111
10000010000001
1010101A101001
11101010100101
10001010111111
11101110000011
11100000101111
111G0101100011
11110100111111
11111111111111