Level size: 16
Polisher percentage: 50
Starter line: 0100101111110000,
Whole Level:
111111111111111111
1111011111110000E1
110100000000010001
110000101101010001
110101101001000101
110111001010001111
110001101010100011
111011101010101011
100001001G00101011
101001011101110011
101101010000010111
111001011101000111
110001001101100011
111100101000100001
111011110010010011
111A00000011111111
111111011011111111
111111111111111111