Level size: 16
Polisher percentage: 50
Starter line: 1100011000000101,
Whole Level:
111111111111111111
11E000100000011111
110100001110111111
110101111010000111
110100011010111111
110101000010000111
100110010010010001
100010110111111001
11001010A001110101
110100100100000101
111000110101110101
100010010101110111
101011010100100111
111011010110110111
110001010010110111
10001000011010G111
101010100110111111
111111111111111111