Level size: 16
Polisher percentage: 50
Starter line: 1111100001101000,
Whole Level:
111111111111111111
1111110000111100E1
110110110000010001
110100110101100101
110110011100101111
110010000001100011
110111110000101101
11010100A110000001
110101011110000111
110101110000101111
110100000111101001
110111111000000001
110001000010100001
111011110111001001
1G0001000100011001
111000001101001011
111010011101111011
111111111111111111