Level size: 12
Polisher percentage: 50
Starter line: 100110011110,
Whole Level:
11111111111111
111110001110E1
11100010000011
10001110101011
11110000100111
11000110100011
1110001A111001
11000100011011
11110101110011
10000100010011
11111110111011
10000000001011
1G011111111111
11111111111111