Level size: 12
Polisher percentage: 50
Starter line: 000000000011,
Whole Level:
11111111111111
1E000000000111
10000000000011
10000000001001
10000000101011
10000001101011
10000G10001011
10000010111011
10001010110011
10001011100111
11101000101111
111010011A1111
11101111111111
11111111111111