Level size: 10
Polisher percentage: 50
Starter line: 1001110101,
Whole Level:
111111111111
1111111110E1
111100001101
100001101001
111110000011
100000100111
110010G10001
110111010111
110100010111
110111010001
11A011011001
111111111111