Level size: 20
Polisher percentage: 50
Starter line: 00110110110010010010,
Whole Level:
1111111111111111111111
11111011111011101111E1
1110001000000010001101
1110101010101110100001
1110101011000010101001
1110101010010111101011
1010101111110000101111
1011100111000010100001
1000000000011010101111
1011011111101100100001
11010101100G0001101111
1101110000011101001011
1100000110100001011001
1111111010111101001011
1110000000000001011011
1000101111101000010011
1100101110001011010111
1101000100101110000001
1100011111110000110111
11A1100000000111000001
1111111111011100000001
1111111111111111111111