Level size: 10
Polisher percentage: 50
Starter line: 1101101111,
Whole Level:
111111111111
111010011111
1E0000000011
100011110011
10000G011111
100011011111
100011001101
1000000110A1
100101000011
110101011111
111101001111
111111111111