Level size: 8
Polisher percentage: 50
Starter line: 00010100,
Whole Level:
1111111111
1E00001001
1001101001
11101G0011
1110000011
1000101011
11101010A1
1110100011
1111110111
1111111111