Level size: 12
Polisher percentage: 50
Starter line: 101110100000,
Whole Level:
11111111111111
111111110000E1
11000001000001
11011100010001
11000101111001
11010000000101
110001G1010111
11101101100011
10000000001111
10000011100011
10000000011111
10000011011111
1A000011001111
11111111111111