Level size: 12
Polisher percentage: 50
Starter line: 011010001011,
Whole Level:
11111111111111
1E111100011111
10000111000001
11011011001001
10001010011001
100000G0100011
10111110101011
11011010101011
11000011101011
11010000001011
10010111111011
11010100000A11
11111101111111
11111111111111