Level size: 14
Polisher percentage: 50
Starter line: 00110111011000,
Whole Level:
1111111111111111
1E01111100100001
1100000000001001
1110101101011101
1000110001101011
1111000100001011
1100010101011011
11011101G1110011
1101100100000011
1100101110111011
1110101000001111
1100100010100001
1001110111101101
11100001000010A1
1110111111111111
1111111111111111