Level size: 10
Polisher percentage: 50
Starter line: 1110110010,
Whole Level:
111111111111
111001101111
100000000E11
111010101111
100011110011
11000A000111
100011010111
101010011111
111011000111
110001000011
1G0111101111
111111111111