Level size: 12
Polisher percentage: 50
Starter line: 111010101101,
Whole Level:
11111111111111
11111100011111
1E000001000011
11101101111111
11000110010011
11010000000111
11010111111111
110100A0000011
11011111111001
11000000100011
11010110001111
100100001000G1
10011110110111
11111111111111