Level size: 20
Polisher percentage: 50
Starter line: 00100011001000110110,
Whole Level:
1111111111111111111111
10011111111111111110E1
1001011000100000110011
1101001101110011100111
1101100100010000001011
1100100111000011101001
1101110001110100010011
1100010100110001110111
1101111110000110010001
1100010011110010000111
1110110100G00000010011
1000000111111011001111
1010100000000000000011
1011001011101011010111
1100011010001001011111
1101001010101111000111
1101011010101110101111
1101010011000000100001
1001011100011101111011
1A10010001000100001011
1111110111111111111111
1111111111111111111111