Level size: 20
Polisher percentage: 50
Starter line: 11100111110100110000,
Whole Level:
1111111111111111111111
11110111111111110000E1
1000011000000000010001
1110001010010101111001
1101100111010100000101
1101101000010111101111
1100001111010110100011
1101110101011000101001
1100100100000011110011
1101101100111110010011
11010001000G0010111011
1101011101111100000011
1101000100000001011111
1101001101111101000011
1100010100000101111111
1101010101010100000011
1101000001010010101011
1101000011011010101011
1101010011011010101011
1101011000001010101011
11A1111110111110111001
1111111111111111111111