Level size: 16
Polisher percentage: 50
Starter line: 1100011010110010,
Whole Level:
111111111111111111
1100001111111010E1
110100000000000011
110101111110101111
110101100100100011
110100000101111111
110101010101001111
110111110110000001
110000011A00111001
110111000010000101
110000111010111111
111010001010000011
110010101110101101
100011100110100001
101000010110101101
101101010100101001
1G0111111001101111
111111111111111111