Level size: 14
Polisher percentage: 50
Starter line: 00111000001100,
Whole Level:
1111111111111111
1E01100000010001
1100001000000101
1110101101110111
1100101100010011
1001101001011011
1110001011101011
1110101G00001011
1100101000110011
1000110010110011
1110011010001011
1101111011101011
1100000001001111
1101101001100A11
1111101101101111
1111111111111111