Level size: 8
Polisher percentage: 50
Starter line: 10111100,
Whole Level:
1111111111
11111100E1
1100000101
1111101111
1000G00011
1110101001
1100100011
1000110111
1A10111111
1111111111