Level size: 12
Polisher percentage: 50
Starter line: 110011111000,
Whole Level:
11111111111111
111001111000E1
11001011101001
10001000001101
11101011000011
1000110A011111
11100111000001
11000011001111
11010000000001
11010110100111
11010110100111
11010010110011
11G11110111111
11111111111111