Level size: 8
Polisher percentage: 50
Starter line: 10101000,
Whole Level:
1111111111
11101100E1
1100010001
1101000101
11011A1101
1101100101
1101000101
1001010101
1G11010111
1111111111