Level size: 14
Polisher percentage: 50
Starter line: 01101101100001,
Whole Level:
1111111111111111
1E11011110000111
1000000000100011
1101010110101011
1101010010110111
1101000111000111
1101010G00000011
1101001111111001
1101100000011011
1101001011100011
1101001110001111
1001100000100001
1000110111111111
1110100000000A11
1110111111111111
1111111111111111