Level size: 24
Polisher percentage: 50
Starter line: 000110011111101001111001,
Whole Level:
11111111111111111111111111
1E001000111111111111111111
10010011000100000000001111
10010110110111101011100111
11010000010000001110111111
11010111110001000000000111
11010001110101011111110111
11011100100111010000011111
10001010101000010111000001
11101000100011110110011001
10001110101110010011000101
11100100100000111000011111
11010101111G10010011001011
11010000011011110100010011
11010101000000110001110111
11011101011110010110010001
10001001001011110010000111
11101111101000100000010011
11000010000011101011001111
11011011101100001000000011
11011000100001111111010111
11100000000100000001011111
11111001101101111111000111
10000010001100000000010111
1001111010111111001111A111
11111111111111111111111111