Level size: 16
Polisher percentage: 50
Starter line: 0000111000011000,
Whole Level:
111111111111111111
1E0001100000100001
100000001100001001
100110101101111001
111000100100011011
111011110011110011
100000011000001111
111101001010100111
1000011A1010001111
101000101010100001
101010101000001111
110010101010100011
110110101010101001
110100100010100011
110110101010010111
110100101010010111
11100111101111G111
111111111111111111