Level size: 20
Polisher percentage: 50
Starter line: 01111100011001100000,
Whole Level:
1111111111111111111111
1E11110000000000000001
1001110101001000100001
1100000101100001100001
1101101000100100101001
1101001011110110101001
1101111001011000110011
1100100011000000111011
1111101010000100011011
1110001110111001001001
1100100000G10011111001
1110000110111000110011
1110110100100010010111
1111001111101011010001
1111100000001010010111
1111101001001010100011
1111001011011110101011
1111101010000100101011
1111110011010101110A11
1111110001010100010111
1111110111111111111111
1111111111111111111111