Level size: 8
Polisher percentage: 50
Starter line: 00000101,
Whole Level:
1111111111
10000000E1
1000001101
1000100111
10001G1111
1110100011
1110111011
1010111011
1A00111111
1111111111