Level size: 18
Polisher percentage: 50
Starter line: 010011000010000000,
Whole Level:
11111111111111111111
111111000011000000E1
11000000100000000001
11110110110101000001
11000011000101000001
11111100011110010001
10001101001000110001
10100001111010010101
111011110G0011010111
11100000010001010111
11101101010101010001
11110001110101010001
11100100110101010101
11001111100101010111
11101000001101010111
11101010101001011111
1A011010111001000111
11000010001000100111
11110111011011110111
11111111111111111111