Level size: 12
Polisher percentage: 50
Starter line: 110000110010,
Whole Level:
11111111111111
110000011110E1
11011100000011
11000011111111
11011000000011
11001110001011
1110010G111011
10000110000111
10110010010111
10100011110011
11001000001011
11101010101011
111A1110111111
11111111111111