Level size: 12
Polisher percentage: 50
Starter line: 001100100000,
Whole Level:
11111111111111
1E011111000001
11000011000001
11101011010001
11101000010001
11001101000101
111111A1010111
11000001010011
11010001011011
11010101010011
11010011010111
11010100010001
110101101101G1
11111111111111