Level size: 14
Polisher percentage: 50
Starter line: 11111110100011,
Whole Level:
1111111111111111
1111111111111111
11E0000001000011
1101111111011001
1100000000000011
1101110111011111
1100011110001011
11010000G0000011
1101110111111111
1100011000000011
1101000001111001
1000011000000011
1001001101011111
10011001010000A1
1101110101010111
1111111111111111