Level size: 16
Polisher percentage: 50
Starter line: 0110111000000001,
Whole Level:
111111111111111111
1E1111100000000011
100000001000000011
110101101000001011
100101001010101001
101001100010101011
111111101011101011
110000001000111011
110111011A10010011
110100011001011011
110101000010001011
110101111010110011
110100110010010111
110000000111010001
111000100100010111
111010101101110001
1111101111111110G1
111111111111111111