Level size: 24
Polisher percentage: 50
Starter line: 010101001101000110101101,
Whole Level:
11111111111111111111111111
1111E111111111111111111111
11100011000011000001000011
11101000010000011111110111
10011111010111001000010001
11001101010100111001100111
11100101110100001100001111
11001000100101110001100001
10000011101101001000011111
11101000000001011001000011
10001101110101010001111011
11110101000110010101101111
1101010101000G100101100001
11010111010110001111000101
11010000010000100000010101
11011111111110101111010111
11000000000000100110010111
11111101111010110001110001
10000001000010001110110111
10101101101010101000000011
10100101001010111010101011
11111101010010000010101001
11000001010111011010100011
11010110010100001011101011
11110111110110011001101A11
11111111111111111111111111