Level size: 12
Polisher percentage: 50
Starter line: 110010000010,
Whole Level:
11111111111111
111111000000E1
10001100000101
10101101010101
11100001010111
11000110010111
110110A0111111
11011010000111
11010010111111
11010100000011
10010001101101
1G100101000001
11111101111111
11111111111111