Level size: 8
Polisher percentage: 50
Starter line: 00100111,
Whole Level:
1111111111
1001111111
10010000E1
1101010101
1100011101
1101G00111
1000111111
1000000011
1A11111111
1111111111