Level size: 22
Polisher percentage: 50
Starter line: 0100011101000110001110,
Whole Level:
111111111111111111111111
111111111111111000011111
111011000010000010000011
1E0000011110101110101011
111110001000101100101011
110110111010100111101011
110000000010110001001011
110110111111010101111011
110110101100011100110011
110100100001100010001111
110100001110001000100001
111110000000100111101111
110011001111110000000011
11010000000G010111101001
110101010101010010100011
110101011101110000101011
110101011000000111111011
110111000011000000000111
110000011000101011010111
110101001010111001000011
110101001010110101011001
110101011010000101001011
111101011110111101111A11
111111111111111111111111