Level size: 16
Polisher percentage: 50
Starter line: 1111000010010100,
Whole Level:
111111111111111111
1111100011111000E1
101100110100101101
100000110110100011
111010100000001011
111010110100111011
100110011100000111
110000001100110111
11011100G000010111
110100011101010111
110111011101010111
110001001001010001
111110011110000111
100011000110101111
100000010100100001
1A0111010100111111
110111010110111111
111111111111111111