Level size: 16
Polisher percentage: 50
Starter line: 1010010111110000,
Whole Level:
111111111111111111
1101101111110000E1
110110000011010001
110000101000010001
111110101001000101
100000101101011111
111010101001000011
100010111G11101011
100100001010001111
110101101010100001
110101101010101011
110100101100101011
110101000100101101
111101011110100001
1A0001001000101101
111111111001000111
111111111101011111
111111111111111111