Level size: 10
Polisher percentage: 50
Starter line: 0001010100,
Whole Level:
111111111111
1000100110E1
100010001001
111000100011
111101111011
10000A001011
111101101001
100000101101
101010101101
1G1010100011
111110111111
111111111111