Level size: 14
Polisher percentage: 50
Starter line: 10100101110101,
Whole Level:
1111111111111111
11011011111110E1
1101101001001101
1100001011011001
1111100000000011
1000000101110111
1100011110000001
1101010A00010101
1111100111010101
1100110100010111
1110000101100011
1110010100101011
1000010110001001
1010110110101001
1G01111110101111
1111111111111111