Level size: 14
Polisher percentage: 50
Starter line: 11001110101111,
Whole Level:
1111111111111111
111E011111111111
1100001001000011
1000011101101011
1111010100101111
1000010101100001
11110100A0001111
1100000011100001
1101111000011111
1100100011000011
1111101001111011
1000001000001111
11000110101000G1
1110001010100111
1110111010111111
1111111111111111