Level size: 12
Polisher percentage: 50
Starter line: 101000001101,
Whole Level:
11111111111111
11E00000011111
11011011000011
11000110111011
11101000001011
11100011101001
1000100G101101
10001110101101
10000010000011
10010111111111
11010000000001
110101111110A1
11110111111111
11111111111111