Level size: 24
Polisher percentage: 50
Starter line: 101100101111100011110000,
Whole Level:
11111111111111111111111111
11111011111110000111000001
11E00000000110100000010001
11101010100000101010110001
11001010101111101010100101
10001010101000001011101111
11101000111100100001000011
11101011000001110101010001
10001011010100010010010011
11101010010111010110111011
10001010100010010100001011
11110010001011000100110011
11011000101011011110010011
1100000110101G001000111011
11011100101010110010001011
11010111111010110111011001
11010000000011100100001101
11011111010000101101010001
11011100010001000101010111
11001001011101011110010111
11111010001001001000110011
11110010101011101010001111
11111110101000101010000001
111110001011111010101010A1
11111010100111111011111111
11111111111111111111111111