Level size: 20
Polisher percentage: 50
Starter line: 10001100100111111010,
Whole Level:
1111111111111111111111
11111111111111111100E1
1110000010010000000111
1000111111010011110001
1110000001000000100111
1101011111010111101111
1101010001010001000001
1101010101011111010111
1101010101010110010111
1101010101010100010001
1101010101G00001010111
1101010111001101010111
1101010001010001010111
1101010011011011010001
1101000101010101000111
1101110101010100011111
1100000000000001000001
1110110000000001010111
1000010100000101010111
1010110100001101010111
1A01111101001101011111
1111111111111111111111