Level size: 22
Polisher percentage: 50
Starter line: 1001000100010001100111,
Whole Level:
111111111111111111111111
111011100000111110001111
1110111111011011001000E1
101001001000000101101111
100101011011111000000011
110101001000000010101001
110101011101011110100011
110100000001110100101111
110111010100000111100111
110000010001111000110111
111111110101000010111011
110000000111011110001011
11011111000G000001011001
110011000111010101001101
111110010010010111111001
100000111011010000000011
111010001011010010101111
100011011100011010100001
110001000100001010111011
110101010110101010011011
110101010010101001001001
110101011010101101011001
1A0111111010100101111111
111111111111111111111111