Level size: 18
Polisher percentage: 50
Starter line: 111100110010010011,
Whole Level:
11111111111111111111
11111001111110111111
11010010001000000E11
11010010101010110111
11000000101011000111
11010110101011011111
11110010111000000111
11001100010001001111
11100001100101000001
100001000G0011110111
11111111101000000011
11000000001110111011
11010111100000001111
11010110001101000011
11110100100101101101
10000110111000100001
10100010011010101101
1A101010100011000111
11101110101001011111
11111111111111111111