Level size: 8
Polisher percentage: 50
Starter line: 11100000,
Whole Level:
1111111111
11100000E1
1110100001
1110100001
10001A1001
1000011001
1000111011
1001111011
1G11111011
1111111111