Level size: 18
Polisher percentage: 50
Starter line: 011100001000101011,
Whole Level:
11111111111111111111
10110000111101000111
100001110001000110E1
11010111010110110001
11010000011100000101
11011111000001111111
11000000011100000011
11101111000011011011
10000001011001010011
10100001000101010011
101001001G1101011011
11110101100101111111
11000100011100000011
11110101001001101011
11000101111100101011
11101000000010101111
11101001111010000111
10001100101011110111
1A001110000001111111
11111111111111111111