Level size: 14
Polisher percentage: 50
Starter line: 10111011011000,
Whole Level:
1111111111111111
11111111111000A1
1100000011001001
1111101000001101
1101101010101011
1100001010101011
1101111010101011
1100100010111011
1111101010000011
1000001011010111
1100100001010001
1101111010011001
1100011010110001
1101100010010101
11G0101111110111
1111111111111111