Level size: 14
Polisher percentage: 50
Starter line: 01110101001100,
Whole Level:
1111111111111111
11111110111100A1
1100000011000101
1101111000011111
1100101111001011
1111100000010011
1000101110010111
1110111000000001
1000000111010111
1110100000010111
1111000110110001
1100010100110111
1101010011000111
11G1010100010001
1111110101110101
1111111111111111