Level size: 10
Polisher percentage: 50
Starter line: 1011111100,
Whole Level:
111111111111
1111111100A1
110001000101
111011010111
100000011111
111011000111
100011011111
110001101001
110100101001
1G0000000011
111100111111
111111111111