Level size: 12
Polisher percentage: 50
Starter line: 111110100110,
Whole Level:
11111111111111
111111111110A1
11000000000011
11010110101111
11010100100001
11011100101011
11000110101011
11010010011111
10000110000011
10010011011111
1G010001000111
11010101010001
11110111111001
11111111111111