Level size: 10
Polisher percentage: 50
Starter line: 1011100000,
Whole Level:
111111111111
1111100000A1
110000100001
111110100001
100000101001
110010101001
110111101011
110100001011
110111011011
11G100010011
111000111111
111111111111