Level size: 12
Polisher percentage: 50
Starter line: 010011101110,
Whole Level:
11111111111111
111111110110A1
11011000000011
11000010001011
11000110101011
11100010100011
10001110101011
11000100111001
11011100011011
10000000100011
11111101111011
10000000001011
1G011111111111
11111111111111