Level size: 14
Polisher percentage: 50
Starter line: 01000001111010,
Whole Level:
1111111111111111
111A000011110001
1110011000000111
1000111110110001
1110100000100111
1000110110101111
1111000110000011
1101010100101101
1101010111100001
1101010000001101
1101010111011001
1101110100000111
1100011101010111
1110000001000011
11101111011110G1
1111111111111111