Level size: 10
Polisher percentage: 50
Starter line: 1100000111,
Whole Level:
111111111111
11A000001111
110101010001
110101010111
110101010111
110111010111
110001000001
111011000001
111001010001
111011010001
1111111101G1
111111111111