Level size: 10
Polisher percentage: 50
Starter line: 0010010100,
Whole Level:
111111111111
1A0111100001
100100101101
110110100011
110000001011
111110111011
100000000111
110010010111
110111011111
100001000001
1111011100G1
111111111111