Level size: 12
Polisher percentage: 50
Starter line: 110110111011,
Whole Level:
11111111111111
11A01111111111
10000000100011
10001101101001
10000110001101
10000110101101
10000000100011
10001101111011
11101000001011
11101101101001
10000100101101
100001011011G1
10000011111111
11111111111111