Level size: 14
Polisher percentage: 50
Starter line: 11111011000110,
Whole Level:
1111111111111111
11111111000010A1
1100000001000011
1101010111011111
1101011100000111
1101001000010011
1101111010111011
1100100010001011
1111101010111001
1000111010000011
1100000011011011
1000110001001011
1G10110101011001
1110010101000011
1111111101011111
1111111111111111