Level size: 12
Polisher percentage: 50
Starter line: 111000000011,
Whole Level:
11111111111111
1110000000A111
10001000000011
11001000001001
10011010101011
10110110101011
10100000101011
10101011101011
11101011001011
11001010011011
10010010100011
10010110110111
1G001111111111
11111111111111