Level size: 14
Polisher percentage: 50
Starter line: 11001110111110,
Whole Level:
1111111111111111
11100111111110A1
1100100000011011
1000011101000011
1111000001011111
1000010110000011
1011010010011011
1010011011001111
1100100000100001
1110101010100101
1000101010101101
1101001111000111
1101000111010111
11G1010010010011
1111011111111111
1111111111111111