Level size: 14
Polisher percentage: 50
Starter line: 11001110111001,
Whole Level:
1111111111111111
1110011101111111
1100100000101111
10000111101000A1
1111010110101111
1000010100100011
1111000000110011
1100011110010011
1101000000111011
1101011010001011
1101110111011001
1000000000001101
1111110111011001
1000000000000011
1G01110011011111
1111111111111111