Level size: 10
Polisher percentage: 50
Starter line: 1100111111,
Whole Level:
111111111111
111A01111111
110010000001
100000011101
111010000111
100011111111
110001000111
100000010001
101000111001
1111100001G1
111111110111
111111111111