Level size: 12
Polisher percentage: 50
Starter line: 001001100011,
Whole Level:
11111111111111
1A011111000111
10010100100011
11010101001001
11000000000011
11010011010111
11010100011111
11110101000111
11000101000111
11101110010001
11000011000101
100110110101G1
10011011010111
11111111111111