Level size: 8
Polisher percentage: 50
Starter line: 00110010,
Whole Level:
1111111111
10011110A1
1100000011
1110101011
1000101011
1100101011
1101110011
1000010111
1G01111111
1111111111