Level size: 12
Polisher percentage: 50
Starter line: 111010110101,
Whole Level:
11111111111111
11111111111001
1A000100001101
11101101110001
11000100000111
11011101010111
11000001010011
11000111001111
11010000111001
11011010000001
11001010101011
11101011101111
111010011000G1
11111111111111