Level size: 12
Polisher percentage: 50
Starter line: 111110110101,
Whole Level:
11111111111111
111111111110A1
11000011001101
11010100100001
11010101100111
11010000101111
11011100001001
11000111000001
11111000010001
10000010110001
1G011010100101
11100011111111
11101001111111
11111111111111