Level size: 12
Polisher percentage: 50
Starter line: 111000001110,
Whole Level:
11111111111111
11100000011111
1A101111001011
10001101101011
10011101101011
10000000011011
10000111000011
10000000111111
10000110000011
10000110111001
10000010001101
100010101011G1
10101011101111
11111111111111