Level size: 8
Polisher percentage: 50
Starter line: 00100010,
Whole Level:
1111111111
10000000A1
1011101111
1100000001
1101101101
1101100101
1101000111
1001010111
1G11010111
1111111111