Level size: 12
Polisher percentage: 50
Starter line: 010001001111,
Whole Level:
11111111111111
111A0011111111
11101110101011
10000110101011
11110000001011
10000111110011
11110000110111
10000001000111
11001000010001
11111011000111
10000000011011
11001010000011
11111110111G11
11111111111111