Level size: 10
Polisher percentage: 50
Starter line: 1100110010,
Whole Level:
111111111111
1100011110A1
110100000011
100001101011
101101001011
101101100111
110011000011
111000010001
1G0010010011
111100011111
111111001111
111111111111