Level size: 8
Polisher percentage: 50
Starter line: 00101111,
Whole Level:
1111111111
1A01111111
1000000011
1100111011
1110001111
1000000001
1101010111
1001000011
10111110G1
1111111111