Level size: 8
Polisher percentage: 50
Starter line: 00110111,
Whole Level:
1111111111
1A01111111
1100000001
1110100101
1000110101
1100010111
1101000011
11011110G1
1101111011
1111111111