Level size: 14
Polisher percentage: 50
Starter line: 10100011100111,
Whole Level:
1111111111111111
11A1111110001111
1100011000100001
1101000010001111
1101011010100011
1001010010111001
1010011011100011
1111111000001011
1100000010101011
1101001010111011
1101011100001011
1101000101101011
1001100101001011
10001010010010G1
1110110011101011
1111111111111111