Level size: 14
Polisher percentage: 50
Starter line: 01000011100001,
Whole Level:
1111111111111111
1111111111001111
1110100000100111
10001110101100A1
1110010010000111
1100111111110111
1000000000010111
1100101111000001
1000101100010001
1010100100100101
1110100110101111
1000110010100011
1100011110101011
1001010000100111
1G11010111111111
1111111111111111