Level size: 10
Polisher percentage: 50
Starter line: 0001101100,
Whole Level:
111111111111
1000111100A1
100001100101
101100000101
110001010101
110101010101
110101010101
110101011101
110101000111
110101110111
11G111110111
111111111111