Level size: 10
Polisher percentage: 50
Starter line: 1110101100,
Whole Level:
111111111111
1111111100A1
100000000101
111101111111
110000000001
110110101111
110100100001
110100101011
100110101001
1G0010101001
111111111111
111111111111