Level size: 14
Polisher percentage: 50
Starter line: 10010110111010,
Whole Level:
1111111111111111
11101111011100A1
1110000000000111
1011011110110001
1000111000000111
1110000010100011
1000111110101011
1111000000111001
1100010100011011
1101011000110011
1101001010000011
1101001000101011
1101011110101011
1101010000101011
1G01110111111111
1111111111111111