Level size: 10
Polisher percentage: 50
Starter line: 1011100110,
Whole Level:
111111111111
111111001111
110000000A11
111110011111
101100000001
100001010111
110011010111
100001011111
100111000111
100000110011
1G0010111111
111111111111