Level size: 10
Polisher percentage: 50
Starter line: 1111000000,
Whole Level:
111111111111
1111000000A1
100001000001
110011000001
111010010001
100011110001
101101110101
111000000101
11G001110101
111100110111
111111110111
111111111111