Level size: 14
Polisher percentage: 50
Starter line: 11111000001110,
Whole Level:
1111111111111111
1111100000011001
11A1101000000011
1100001000101011
1101101010101011
1100101010011011
1110101010100011
1000101011110111
1100100000010001
1101111010011001
1101111010110001
1101100010010101
1100101110110111
1111100010010001
11111111111100G1
1111111111111111