Level size: 16
Polisher percentage: 50
Starter line: 1011011010010001,
Whole Level:
111111111111111111
111111111110111A11
110000000010111011
111101011010000001
110101010000011001
110101100010010001
110100111010100101
110111000010100101
110000011100100101
110111100011101111
110100001000000011
110111011111001001
110100010000010011
110101100100010011
110101110101001011
110100010101011001
11G111111111001011
111111111111111111