Level size: 12
Polisher percentage: 50
Starter line: 010100100010,
Whole Level:
11111111111111
111A1101110111
11001101110111
11010100000001
11010000101111
11011010100001
11000010111111
11100010000011
10001011101101
11101010000001
100011110110G1
11100001001011
11111101000111
11111111111111