Level size: 14
Polisher percentage: 50
Starter line: 10000010110011,
Whole Level:
1111111111111111
1100000111110111
11000000001100E1
1101010010000111
1101011110111111
1101000110000011
1101010010101101
1001111010100001
1000001G10101101
1100101011101001
1000100001001101
1010010101101001
1011010101101011
1001010100101111
1A01111111100111
1111111111111111