Level size: 14
Polisher percentage: 50
Starter line: 01000100101000,
Whole Level:
1111111111111111
11111011110000E1
1110100000011001
1000010111010101
1111010001010111
1000010101110001
1110110100000101
1100000111111101
1101011G00110111
1101010011000111
1101110110011111
1100000110000111
1110100000111011
1110101010000011
1A00011011111011
1111111111111111