Level size: 20
Polisher percentage: 50
Starter line: 01011001101101100000,
Whole Level:
1111111111111111111111
11111110111111100000E1
1100011010100010100001
1101010010001010110001
1101010110111010001001
1101010110001110101101
1101010000110000100011
1101110111000101111011
1000000000010100001011
1110110011110111101001
1000001001G00001101101
1000111101101101001101
1000000101000101100011
1000110101011100001111
1000110011001110100001
1000010100100010101111
1001011100011110101011
1101000001000010000011
1101000101010111011111
1001010011010001001111
1A11011110011111111111
1111111111111111111111