Level size: 20
Polisher percentage: 50
Starter line: 00001101000111011010,
Whole Level:
1111111111111111111111
1E00011111111111111111
1000000011000000000111
1000101000010111010011
1110100101110001011001
1110110100001001000011
1000010110011101011011
1010010100000101010011
1011010101011101011011
1100010101001001001011
11010101011G1011101011
1101011100101011101111
1101000011101001000001
1101101001001011100101
1100101011011000010101
1110101001001010011111
1000100101011010000111
1100111101011010111111
1100010001011000011001
11011000110010100000A1
1111111000101010111111
1111111111111111111111