Level size: 8
Polisher percentage: 50
Starter line: 01100001,
Whole Level:
1111111111
1E10000111
1000111111
1100G10001
1101110101
1101100101
10001011A1
1010000111
1011111111
1111111111