Level size: 22
Polisher percentage: 50
Starter line: 1011001000000010110101,
Whole Level:
111111111111111111111111
1111101100000001111110E1
110000110000000000001101
111010000100010011010001
110010101110111001000111
100110101000001011010111
111000111010101110010111
111010010011000001110001
100011010001011000110111
101001010101G01001100011
111101011000011100001011
110001001001000101101001
110001111101010100000011
110100110001010101011111
110110100110011001000011
110010111000000101011001
111010010010011101011011
111010111111000101010011
1A0010001100000110000111
111100101000100010100111
111110011010101010101111
111110001010101010101111
111110111011101100011111
111111111111111111111111