Level size: 14
Polisher percentage: 50
Starter line: 00111110111101,
Whole Level:
1111111111111111
1E01111111111111
1100110000010011
1110010101010111
1100110111110001
1000100000000101
1100101111111101
1101000G00110101
1101101111100101
1101001000101101
1100010010000111
1111010111100111
1011000000110001
1000010110001111
11101100101000A1
1111111111111111