Level size: 8
Polisher percentage: 50
Starter line: 11010100,
Whole Level:
1111111111
11111000E1
1000001101
10001G0011
1100010011
1101111011
1101101111
1100000011
11A1111111
1111111111