Level size: 18
Polisher percentage: 50
Starter line: 101000110111001111,
Whole Level:
11111111111111111111
11E11111111100011111
11000000000001000011
11010111101110001011
11010100000000100111
11011111001110100011
10001101110000101001
11000000011110100011
11011101000000101011
1000000101G100101111
11110101010110100011
11000010010110101011
11010111100010101011
11010001101010001001
11011110001001101011
11100000010011101011
11101111010100001011
11101000010010111011
11101100111110111A11
11111111111111111111