Level size: 14
Polisher percentage: 50
Starter line: 01111000010101,
Whole Level:
1111111111111111
1E11111101100111
1000000001100011
1101010100001011
1101010101011011
1101110101010011
1000000101110011
1100011G00011001
1101011010000111
1101100010110011
1100100010001011
1110101011101101
1110101010000001
11101011110110A1
1000100111111111
1111111111111111