Level size: 18
Polisher percentage: 50
Starter line: 000011011001110001,
Whole Level:
11111111111111111111
1E000111111111111111
10000011000000000111
10011000010101010111
11100010110101011111
11101010010101100111
11001011110101000111
10010010110101010001
111001000G0101110111
11111101111101000001
10110001000000000001
10000101010110000001
11101101010001000001
11101001010001000001
11101001100101010001
11111100110001010001
111101110001010001A1
11110000010101010111
11111111011101110111
11111111111111111111