Level size: 14
Polisher percentage: 50
Starter line: 10110110011010,
Whole Level:
1111111111111111
1111111111110001
11E0100010000111
1101101100100011
1101101110101001
1100000110100011
1101110010001111
1100010000110011
11101110G0000111
1110001100110111
1000101100010111
1100100001110111
1101101100010111
1110000001110001
11110011001101A1
1111111111111111