Level size: 12
Polisher percentage: 50
Starter line: 100101000001,
Whole Level:
11111111111111
111E0110000011
11100000000011
10111010101011
10000010101001
1101110G100011
11010001001011
11011101011011
11000101001001
11111001000011
11111111011111
11110000000A11
11111101011111
11111111111111