Level size: 10
Polisher percentage: 50
Starter line: 1110001011,
Whole Level:
111111111111
111001111111
1E0011110001
111000001001
100011111001
111000001011
110001G11011
110101110011
110100000011
110110101001
1111111010A1
111111111111