Level size: 18
Polisher percentage: 50
Starter line: 000100011010000110,
Whole Level:
11111111111111111111
111111111111111110E1
11111011000000000011
11100001111010101111
11101101001110101001
11110000000100101001
11101101010110101011
10000001010001101011
11010101010100001001
1101010100G101000001
11011101011001010001
11000101011101010001
11111110000000100101
10000000111111101101
11101111000000001001
11110000000101111001
11111001010100100011
11A00011010101100111
11111111011101110111
11111111111111111111