Level size: 12
Polisher percentage: 50
Starter line: 011111100100,
Whole Level:
11111111111111
111111111110E1
11000000001001
11011110101011
11110000101011
10001110101011
11100101100001
1100110G011001
10000101000001
11110101111001
11000000000001
11011111110001
11A11111110101
11111111111111