Level size: 10
Polisher percentage: 50
Starter line: 1101010110,
Whole Level:
111111111111
111110001001
1E0000110011
100110101011
111000100001
111010110001
11101G000001
111010000001
111100100001
111100100001
1111101010A1
111111111111