Level size: 18
Polisher percentage: 50
Starter line: 000101011111000011,
Whole Level:
11111111111111111111
1E001101111110000111
10001000001101100011
11100111100001101001
11110001001100111011
10000101110000010011
11111100000101111011
11011011111101101011
11000000110000001001
110110100G0111100001
11010010111100001101
11010100010001111001
10010001110101000011
10100110110111010111
11111100100000010111
10000000011011010011
11001101000010011011
11101001011011001011
11111111011001111A11
11111111111111111111