Level size: 20
Polisher percentage: 50
Starter line: 10000111011001111111,
Whole Level:
1111111111111111111111
1111111100111111111111
11E0000001000000000011
1100110111010100111001
1010000001110101000011
1010101010100111011111
1000101110000000000111
1011110101100111010011
1000010101100010011111
1001010100001011001011
1101110101001000000011
11000000011G0011010111
1101110100111001011111
1100010010001111000111
1101011110111000110111
1101000011000010010111
1101111000001000110111
1100011010101011101111
1101010010101000100111
1110000110101110000001
11101101101111101010A1
1111111111111111111111