Level size: 22
Polisher percentage: 50
Starter line: 0010000111001010010011,
Whole Level:
111111111111111111111111
1E0111111111110110111111
100101000001110100000011
110101110100100001110111
110100000111110101100111
110111110011000100100001
110000000000011110000111
111111101011001100110011
100000001001100011101011
101011111100001110001001
101010000001100000101001
11101010110G101011100111
110010100100101011010111
100110101101101000010111
111000101000101011110001
111010101010101001110111
100011001010101100100111
110001001010100110110001
100011101010110010010111
101010001010000111010111
111010110001010001000011
1110100100110101011110A1
111111111011010100111011
111111111111111111111111