Level size: 18
Polisher percentage: 50
Starter line: 100000000111101011,
Whole Level:
11111111111111111111
11E00000001111111111
11000000100000000001
11010101111011111001
11010100001000000101
11010100111010101111
11010011100011100011
11011000100000111001
11001010110100011011
110110101G0101000011
11011010110101011111
11010010010101000011
11011010010101011001
11001010100101011011
11111010101111010011
10000011101000011011
11000000111011001011
11100010010001011A11
11101111011011111111
11111111111111111111