Level size: 16
Polisher percentage: 50
Starter line: 1011100010010010,
Whole Level:
111111111111111111
1111100111001100E1
110000110001000111
111110000111011011
100000111010011011
110010010000100011
111110111010001111
10000000G010100001
111010110010111111
110010001010000011
100110101010101101
111000101011100001
111010111010001101
110010001111111001
1A0010100000001011
111010010101100111
111011111111111111
111111111111111111