Level size: 12
Polisher percentage: 50
Starter line: 000000100110,
Whole Level:
11111111111111
100000011110E1
10000000000011
10000101111111
10000100000001
10010010110101
1001011G010101
11010001010111
11010101110011
11100100001011
10000010101111
10101100100011
1A111101111111
11111111111111