Level size: 18
Polisher percentage: 50
Starter line: 011101101011000000,
Whole Level:
11111111111111111111
1E111111111100000001
10000110000001000001
11011100111011000001
11000001000001010001
11101101010001010001
11101001010101000101
10001001010101010101
10111101010101010101
10010001011101010111
101101010G0101010111
11011101010101110111
11000001010100010111
11011111010100110001
11011000010101000111
11010001010101010111
11010101110101010111
11110111000101010001
110000010001110101A1
11111111111111111111