Level size: 12
Polisher percentage: 50
Starter line: 000001000100,
Whole Level:
11111111111111
100000000000E1
10000011011101
10001010000011
10001010101011
11101010101011
1110101G101011
10001010101011
11001010101001
10010010101011
10110110101011
10011000101011
1A011101101011
11111111111111