Level size: 8
Polisher percentage: 50
Starter line: 10101110,
Whole Level:
1111111111
11000110E1
1101000011
1101111011
1100110011
1110G00111
1000010001
1011010111
1A01111111
1111111111