Level size: 8
Polisher percentage: 50
Starter line: 01101110,
Whole Level:
1111111111
10111110E1
1000000011
1101011011
1101110011
1000G00011
1011101011
1001101011
1A01101111
1111111111