Level size: 10
Polisher percentage: 50
Starter line: 0100001100,
Whole Level:
111111111111
1111111100E1
111000000101
100010001111
110001101011
10000G111001
101010000011
111010011011
100011001001
101001001001
1A0111011111
111111111111