Level size: 16
Polisher percentage: 50
Starter line: 0001011001100000,
Whole Level:
111111111111111111
1E0011111110000001
100000000000100001
110001010101100001
110110011101001001
110100100011011001
110100111000010011
1101010G0010111011
110101111010001011
110100100011101001
110110001001001001
110010011011111001
111111001000110011
111100010010010111
110001010111010111
11111101010001A111
111111011110111111
111111111111111111