Level size: 16
Polisher percentage: 50
Starter line: 0100100101101000,
Whole Level:
111111111111111111
1111011111111100E1
110000010000010001
110101010110000101
110111010110111111
110011010010000011
111110010001111001
100000000100000011
110010000111011111
110100100G01000001
111101101111010111
100000000010010111
101010101011110001
111010101000110111
111010101011100011
111011101000001011
111A01101011011001
111111111111111111