Level size: 16
Polisher percentage: 50
Starter line: 0100010101011000,
Whole Level:
111111111111111111
1111100001111000E1
111011100000001001
100011001011001101
111000001000101011
100010100110011011
111010110010000011
110010001010101111
100111101G11100111
110100001000110011
110101011101101011
110101000100001111
111001010100100001
110010000110101011
111010100010100111
111A10101010100011
111110111010111111
111111111111111111