Level size: 10
Polisher percentage: 50
Starter line: 1100111001,
Whole Level:
111111111111
111E01111111
110010101111
100000100001
111011101111
100000G00011
111101011011
100001010011
111111010111
100000011101
1001100000A1
111111111111