Level size: 10
Polisher percentage: 50
Starter line: 0001100111,
Whole Level:
111111111111
1E0010001111
100000100001
100110101111
110110100011
11010G101001
110100100011
100110010011
100001111011
111100001A11
111110101111
111111111111