Level size: 12
Polisher percentage: 50
Starter line: 001010011101,
Whole Level:
11111111111111
1E000111111111
10110111000011
11000000011011
11010111100011
10011000001011
1010001A101011
11101010111011
10001010100011
11101010101011
11001010101011
100011001110G1
10100110011011
11111111111111