Level size: 10
Polisher percentage: 50
Starter line: 0100110100,
Whole Level:
111111111111
1111111110E1
110000001001
111101000011
110001011111
111011G00011
111000111011
100010001111
100011100001
100000010111
1A1111011111
111111111111