Level size: 22
Polisher percentage: 50
Starter line: 1110011011000100000100,
Whole Level:
111111111111111111111111
1111111111111110000000E1
100000000101100000001001
111100110000001010101011
110001110100111010101011
111000100111000010101011
110011111000011110101011
111101100011110000101011
100000001100000101101011
101001110001010101001011
10101000001G011101011011
111010111111100001010011
100010000000001001010111
111100110100101011110001
110110010101001000100101
110111110111011010110101
110000000001110010010111
110110101000000111010111
110001100111100001010111
111111101011001101010001
1A0000001000011001011001
111101111111010010000101
111101111111011110111111
111111111111111111111111