Level size: 8
Polisher percentage: 50
Starter line: 01010110,
Whole Level:
1111111111
11100010E1
1110110011
1000111011
11000G1001
1101000001
1101010001
1101010001
11A1110101
1111111111