Level size: 10
Polisher percentage: 50
Starter line: 0111101101,
Whole Level:
111111111111
1E1111111111
100100000011
110101110011
110101101011
10000A001001
100011100011
100001101111
1001000000G1
110011010111
111111110111
111111111111