Level size: 24
Polisher percentage: 50
Starter line: 110010011100101010011010,
Whole Level:
11111111111111111111111111
111111111111110011111100E1
10000011010111010110000111
10101100010010010010100011
11100101110110111010101001
11001100010000001000100011
10001010110111111010111111
11101000000000101010110001
10001110110111100010011001
11100000010011001011110001
110111110110G0011000110101
11011100010011000110100111
11000001011010010001110001
11111111000000110101010111
11000000111010010111010111
11011110000011110000010111
11001000111000011111110001
11111010010001000000110101
10000011010101011011000101
11001101011101011000011101
11111001001101000111000111
1A000011111000011000101111
11101000001101000010100001
11101111000001010110111111
11110000010111111110011111
11111111111111111111111111