Level size: 20
Polisher percentage: 50
Starter line: 11010101001010101101,
Whole Level:
1111111111111111111111
1111110111000011111111
1E00100011110100000011
1000101001100101110111
1110011100001100111111
1111000101000000000111
1000010100001010111111
1111110111010010100011
1101010001110111101101
1101000000000000000001
1101011111110101111101
1101000100G00100100011
1101111111010110001111
1100000000010000100001
1101100111010101101111
1101001000010111000011
1101001011100000011001
1101010001101011000011
1101011101001001111011
1101001001111100010A11
1101111100111101011111
1111111111111111111111