Level size: 12
Polisher percentage: 50
Starter line: 101100001110,
Whole Level:
11111111111111
111100000110E1
11000101000011
11001101101011
11010111001011
11010000111011
1101001A000011
11100111011011
11110100001011
10000101011001
10110101010011
10010101011111
1G011101001111
11111111111111