Level size: 12
Polisher percentage: 50
Starter line: 100000001011,
Whole Level:
11111111111111
11E00000011111
11000000000001
11010101001001
11010111101001
11010000101011
1101101A111011
11010010001111
11010010100001
10011010010111
10000111110011
11110000001G11
11110111101111
11111111111111