Level size: 20
Polisher percentage: 50
Starter line: 01000101110001011100,
Whole Level:
1111111111111111111111
11100011111111111100E1
1110011001011000000101
1000101011010011110111
1110100000011000000011
1000111011110010111011
1100000001000111001111
1101111011010000011011
1000000000011111001001
1111001101101101111001
11000111011G0000000011
1110001000101011011111
1100111101101011000111
1111000000001110010011
1000000110100010111111
1110101110001110100011
1000110000100001101101
1111010110101011000001
1100000000101110001101
1101111101000000100111
11A1111111011110111111
1111111111111111111111