Level size: 20
Polisher percentage: 50
Starter line: 10001100110111001100,
Whole Level:
1111111111111111111111
11111111110011100100E1
1110000000000000000101
1000111101011110111111
1011000001100010000011
1111010101101110101011
1100111100000000101111
1110001001101111100011
1100101101000100111111
1001000000000001100001
1110011101111100001001
1111100000G00101111101
1000001101010100111011
1100111001010110000011
1110000001010100011011
1000110101010101011011
1100010101001101001001
1000100001000011111001
1010101011101000110011
1110111000101010011111
1A00001111101111111111
1111111111111111111111