Level size: 14
Polisher percentage: 50
Starter line: 10100110001101,
Whole Level:
1111111111111111
11E1111000011111
1101100010000011
1100001110110111
1101000100010111
1101011101010111
11010100G1000001
1101010001000001
1101111010010001
1000000011110001
1111010101110101
1100010100000101
11010111001101A1
1101000110010111
1111111111110111
1111111111111111