Level size: 10
Polisher percentage: 50
Starter line: 0000111001,
Whole Level:
111111111111
1E0001111111
100000001111
100010100001
111001111011
1111A0011001
100001001101
110101101001
110100101011
110111101111
11001110G111
111111111111