Level size: 8
Polisher percentage: 50
Starter line: 01100111,
Whole Level:
1111111111
1000001111
11001000E1
1111101111
1000000011
11101A1001
1100100011
1000110111
1G10111111
1111111111