Level size: 20
Polisher percentage: 50
Starter line: 01100100010011110101,
Whole Level:
1111111111111111111111
10111110001111111110E1
1000010101101000001101
1110110101101101111001
1000100001000001000011
1110101101011111011111
1000101011000001000111
1110000001011100010011
1100011110000001011111
1111000110111111000011
1100000100G00000110011
1111101110101111011111
1000000000100000000001
1110101111111111010111
1100101100000001010111
1001100000110101010001
1110001010100101011001
1110101010111101000101
1100101010011001000111
1001101011000101010111
1A11101001011101111111
1111111111111111111111