Level size: 8
Polisher percentage: 50
Starter line: 00011010,
Whole Level:
1111111111
1E00111111
1000000111
1001010011
1101G00001
1101110011
1100001111
11110000A1
1111011111
1111111111