Level size: 18
Polisher percentage: 50
Starter line: 010100100111101101,
Whole Level:
11111111111111111111
111E1101111111111111
11001101000100000011
11000101010101110111
11011000010101100011
11011101011101001001
11000000100001100011
11011111001110101111
11000010010000100001
1101111011G111101111
11001000100000000001
11100011101111101001
10000110100000101011
11100000101010101111
11011001101001100001
11011000000011111111
11000010111000000001
110010100110111010A1
11101010011001101111
11111111111111111111