Level size: 10
Polisher percentage: 50
Starter line: 0001011111,
Whole Level:
111111111111
100011111111
100000000E11
111001101101
111111000001
10110G011101
100001000111
111111010111
100000011111
101010000111
1A0110111111
111111111111