Level size: 14
Polisher percentage: 50
Starter line: 00101011011111,
Whole Level:
1111111111111111
1E00000110111111
1011010000001011
1100110000101001
1110000101100001
1000111110001101
1011000000110001
1111101A11000111
1100000100010111
1111111101010111
1101000001010001
1101110111100111
1100000010001111
11111101101000G1
1111111110111111
1111111111111111