Level size: 8
Polisher percentage: 50
Starter line: 01100000,
Whole Level:
1111111111
1E00000001
1100100001
1101100001
1001101001
1101G01001
1101100011
1100100111
111111A111
1111111111