Level size: 12
Polisher percentage: 50
Starter line: 010010101110,
Whole Level:
11111111111111
111101000110E1
11000101000011
11010101111011
11010100010011
11010101011111
110111A1000001
11000001010111
11000110011111
11010110000011
11100001111011
10001100001011
1G101101111001
11111111111111