Level size: 8
Polisher percentage: 50
Starter line: 01110110,
Whole Level:
1111111111
10110010E1
1000000011
1101110111
1100G11111
1101000111
1000111111
1000000011
1A11111111
1111111111