Level size: 14
Polisher percentage: 50
Starter line: 11110100011110,
Whole Level:
1111111111111111
11111111111110E1
1000000011011011
1100111000000011
1110000011010111
1000110001011111
1100010111000111
10001000G0101111
1010101110100001
1110100100111011
1000110100001011
1010010100101101
1110010110100001
11A0100010101011
1111101111111111
1111111111111111