Level size: 16
Polisher percentage: 50
Starter line: 1010101000110101,
Whole Level:
111111111111111111
11E011011111111001
110000000000001101
110101010101010001
110101110101000111
110100011101010111
110111001101000011
110000100011111001
110101101G00111011
100110101110000011
100000100001111111
101011110100000011
101000010010101011
101101010100101011
101001011100111011
111110000110001011
1111101111100110A1
111111111111111111