Level size: 8
Polisher percentage: 50
Starter line: 00001100,
Whole Level:
1111111111
10000100E1
1000000101
1000101111
11101A0001
1100101101
1000100111
1G10010111
1111111111
1111111111