Level size: 12
Polisher percentage: 50
Starter line: 011001100000,
Whole Level:
11111111111111
111000000000E1
11001000100001
11100001100001
11100100101001
11110110101001
1111100A110011
11110000111011
11110100011011
11110101001001
11110101111001
11110100001011
1111G111101111
11111111111111