Level size: 14
Polisher percentage: 50
Starter line: 01011110011001,
Whole Level:
1111111111111111
1111111000111111
11E0011010000111
1110110000110001
1000011011001111
1111011011100011
1100000000001001
1101101011100011
11010010G0011111
1101001011000001
1001101001010111
1000101011110001
1010101000100101
1010101010110101
11101110111101A1
1111111111111111