Level size: 10
Polisher percentage: 50
Starter line: 1001000011,
Whole Level:
111111111111
111E11111111
111000000011
101110101001
100100101011
1101101G1011
110001101011
110100001001
100101000001
101001010001
1111110110A1
111111111111