Level size: 8
Polisher percentage: 50
Starter line: 11101000,
Whole Level:
1111111111
11111100E1
1000000001
1111000101
1000G10111
1101010111
1101010011
1001111111
1A00111111
1111111111