Level size: 12
Polisher percentage: 50
Starter line: 011111011110,
Whole Level:
11111111111111
1E111111111001
10011000000011
11000010101011
11111110111111
100000G0010111
11000110000001
11110100100001
10001101100001
11100001001001
100010111010A1
11101000101011
11111111111111
11111111111111