Level size: 22
Polisher percentage: 50
Starter line: 0100010010111111011100,
Whole Level:
111111111111111111111111
1111101111111111111100E1
111010000000000000000101
100000010010111010110111
111101010110100010001111
100001010101111010101001
111111100100000010100001
110110001101111010110001
110000100101000010001001
110111111110011111011101
110001011000110000000011
111111000010G10101011011
100000001111010101001011
111001100100010101100011
111010110000111011101011
111010000110100000001001
111010110100101011000011
111010110110010001010111
111100100100100011010001
111001111101111001010111
111101000001000111010001
111A01010101010000010111
111111010101011111011111
111111111111111111111111