Level size: 12
Polisher percentage: 50
Starter line: 101110000001,
Whole Level:
11111111111111
11111000000111
11E00010100011
11111010101011
10000010011001
11001001011011
11011110001011
1100011G101011
11011100110011
11000001000111
11010101010111
10010101010001
111101110010A1
11111111111111