Level size: 24
Polisher percentage: 50
Starter line: 011011010011100001010111,
Whole Level:
11111111111111111111111111
1E110111111110001110001111
10000001011000110000100001
11010101000010110101111011
11010101011110000100011011
11011101000000110101001101
11000000010110100101111001
11010111110001110100100011
11010001110100110100001111
10011100000010010101000001
10000011101011110101001111
101010010010G0010111100011
10101101011111010011001001
10100101000110011000100011
11110101010011001010001111
11000101011010001001100001
11000101000111011100001111
10010101110001001001000011
10011100011101001101010001
10000010001101100101010011
10111010101100010101011111
11111100100101011101000011
11000001101111000100011A11
11011000100000110110001111
11111011101001110110111111
11111111111111111111111111