Level size: 18
Polisher percentage: 50
Starter line: 101100000111110100,
Whole Level:
11111111111111111111
111100000011111110E1
11000100000110001001
11101100010000000011
10000101010101010111
10101101010101010001
10110001110101010101
11100100100101010101
11001110110101011101
1110100001G101000111
11001010110101101111
10011110100101100001
11010000100100101111
11010101101111000001
11010100100011010111
11010101101011010111
11010101001110010011
11010101000010011111
1A011111011111011111
11111111111111111111