Level size: 20
Polisher percentage: 50
Starter line: 00010110111000110100,
Whole Level:
1111111111111111111111
1E00111111100001111111
1001100010001000001111
1100011011101011100011
1101111010001000011111
1101010011011010001011
1101010110001011110011
1101000010100001000111
1101111011100111010111
1100000001001000011111
1101111101G00011000111
1101110000001100010011
1100100100001001001111
1111111001000011100011
1100000111011000001111
1101110000110010100001
1100011110000010111111
1111100000101010000011
1110001110101110101101
10001100001000111000A1
1000110111110001101111
1111111111111111111111