Level size: 10
Polisher percentage: 50
Starter line: 1010000100,
Whole Level:
111111111111
1101111000E1
110110001101
110000100011
111010101011
100010G11011
110001010011
110101011111
110101000011
110101111001
11A100111011
111111111111