Level size: 8
Polisher percentage: 50
Starter line: 00101011,
Whole Level:
1111111111
1E00000111
1011010001
1100110001
1110A00101
1000111101
1011011001
11000000G1
1101111111
1111111111