Level size: 20
Polisher percentage: 50
Starter line: 01000001111000011110,
Whole Level:
1111111111111111111111
11100000111000001110E1
1110011100001101000011
1000111110101111101011
1110000000010000001011
1000110111111010111011
1111010001100000000111
1100010100001111010111
1101011101111010010111
1101000000000011110001
11010110001G1000010111
1101010010101111010111
1111010110100001000011
1000010110101101111001
1101010110101000011011
1101010100101101000011
1101010010100101011111
1101010110010101000011
1101010011011000011011
11A1010001001010001111
1111011111111110100111
1111111111111111111111