Level size: 24
Polisher percentage: 50
Starter line: 010101111101010000100111,
Whole Level:
11111111111111111111111111
11110111111110111101111111
111000000000001100000000E1
10001110101110000101110101
11110000100100010100011101
11000111111101011101000111
11010101000001000001111111
11010101110101101100000011
10011000000101100011111011
10100011110100100000001011
11101001000111101101011011
10001100010000001101001011
1011000111011G110001011001
11100100010010010101011011
11001110111111011101010011
11101000001101101100111011
10001010101000000000011011
11010011101100001011001001
11011100000101101000011001
11011001011000111010010011
11001011001000010010111011
11101001101100110100001011
1A001010001110100100110011
11110010100100111110010111
11111111111110011111111111
11111111111111111111111111