Level size: 20
Polisher percentage: 50
Starter line: 00110110010111011111,
Whole Level:
1111111111111111111111
1E01111101111111111111
1100110101000000100011
1110100101011110101101
1000101001001100100001
1110100011000011101101
1000111000001001001001
1110001110100011011101
1101100100111010000011
1101100110G01111011111
1100101010110000000001
1110000010000101010101
1000111110101101010101
1110000000111001011101
1100010010001011100111
1101011001011100001111
1101001111100001100001
1101100000001110111111
1101001010100000000011
1101011010110110101A11
1001111011111110111111
1111111111111111111111