Level size: 8
Polisher percentage: 50
Starter line: 00101000,
Whole Level:
1111111111
10000100E1
1011010001
1101000101
11000A0101
1101010101
1111010111
11G0010111
1110111111
1111111111