Level size: 16
Polisher percentage: 50
Starter line: 0000111000011101,
Whole Level:
111111111111111111
1E0001100000111111
100000001100000011
100110101101011111
111000100111000111
111011110000010011
100001000111011111
111101010000000111
10000111G111010011
111100000000011011
110101110101001011
110110000101010011
110000110101110111
110101000100011111
110101011101000111
110101000100010A11
111101111111011111
111111111111111111