Level size: 14
Polisher percentage: 50
Starter line: 00100111001111,
Whole Level:
1111111111111111
1E01111100011111
1001000101100011
1101010101010011
1100011101011011
1111001001000011
1000000A11111001
1001101010111011
1110101100010011
1110100101110111
1000101100010011
1010001001111011
1111101001000G11
1100000000011111
1111110000011111
1111111111111111