Level size: 12
Polisher percentage: 50
Starter line: 101100100001,
Whole Level:
11111111111111
1111101111E111
11000000110111
11101010000001
11001011100111
10011000111111
11100G10000001
11101011110111
11001000010111
10001101010001
10100101111001
10110100000101
1A011101110111
11111111111111