Level size: 12
Polisher percentage: 50
Starter line: 000111111011,
Whole Level:
11111111111111
1E001111111111
10000001001111
10110100000001
11000000111001
11110010000101
1000111A111111
11000000000011
11011110101101
10000000100001
11110101101101
100001010010G1
10110101111111
11111111111111