Level size: 16
Polisher percentage: 50
Starter line: 0110101101000000,
Whole Level:
111111111111111111
1E1111111110000001
100000000000000001
101011011000100001
101001011001100001
111010001101101001
111100100110001001
111101101000010011
111100101111010111
111101111G00010001
111101000111010111
111111010000010111
111000011110110001
111011100000110111
111100001011000111
111111011001010001
1111110011111101A1
111111111111111111