Level size: 10
Polisher percentage: 50
Starter line: 0011001010,
Whole Level:
111111111111
1E0111110001
110000100111
111110000011
10000A111011
110000001011
111000011001
1000010010G1
111101111011
111100011111
111110001111
111111111111