Level size: 22
Polisher percentage: 50
Starter line: 0010100000010111011110,
Whole Level:
111111111111111111111111
1E0000000000111111111001
101101000000000000000011
110110011110011110101011
110000110011100000101111
110101011000110111101001
111001001110000100000001
110011100000111101100001
111010000111000001101001
110010111000010110001001
100100010010110100010011
11100011101G010101010111
111010111010110101010001
100010010010010101010111
110010111111100110011111
110100001000000010000011
110101011111010100101011
110101000100010000101011
110101001000110110101001
110111101010110110101011
110111101010010110101011
110111101011011000101011
110111111111011110111A11
111111111111111111111111