Level size: 12
Polisher percentage: 50
Starter line: 001001101110,
Whole Level:
11111111111111
100111111110E1
10010000000011
11011010111011
11000111100011
11010000010111
110111A1000001
10000001010001
11001111100101
11010110001101
11100000100101
10001110111111
1G101110111111
11111111111111