Level size: 16
Polisher percentage: 50
Starter line: 0001100100111100,
Whole Level:
111111111111111111
1000111111111100E1
100000010000110101
100101011110000111
110101001011011011
110001001000011001
111011101110001011
100100000110011011
10110110G000000011
100110001110101011
110110101110101011
110000100100111001
111011110110001101
100001000010101001
111101011010101011
1A0001001010101011
111111111010111111
111111111111111111