Level size: 22
Polisher percentage: 50
Starter line: 0101001010100001011000,
Whole Level:
111111111111111111111111
1110111110111110111100E1
111011110001101000001001
110001100100001001111001
111100011110101010001011
110011001010111010111011
110110001010010010000011
110000100000110110111111
110101111110000000000001
111000010000101110101001
110011111111100010101011
111110000000G01010101111
100000101110100110100001
110010110110100011100101
110100100000101000110101
111101101001101110001111
100000001010000001100011
101010101010101000011001
111010101010101011000011
111010111010101010011011
110010001010101011001011
11A011111010101000010011
111011100011110011110111
111111111111111111111111