Level size: 18
Polisher percentage: 50
Starter line: 001101101010000101,
Whole Level:
11111111111111111111
100110111101100000E1
11000010000111011101
11101011110011010111
10001000000000010111
11101111111011110011
11000010000010001011
11011011100010101011
110100000G1011000011
11100111111001011011
11111010110000000011
10000000000111110011
11001010011100000111
11111011110001010111
10000001000100110001
11001011010101000111
11011100010111010111
1A010001011000010111
11110111011011111111
11111111111111111111