Level size: 16
Polisher percentage: 50
Starter line: 0110100001110110,
Whole Level:
111111111111111111
1011111111111010E1
100000001100000011
111110101001110111
100011101000010001
100001001010100111
101101100011101011
110100000001000011
11010110G011011001
110110011001000011
100000111011011111
111100000000000111
100000101101010011
110010101001011111
111111101011011001
100000001011000001
1A0111111111111111
111111111111111111