Level size: 8
Polisher percentage: 50
Starter line: 11001100,
Whole Level:
1111111111
111E010001
1100100101
1000001111
11110G0011
1000001011
1100101011
1111110011
11111100A1
1111111111