Level size: 18
Polisher percentage: 50
Starter line: 110111101100111001,
Whole Level:
11111111111111111111
11E01111011001111111
11010001010010001111
11011001000000100001
11001011011101111111
11100000000100000011
11001011110001011011
10001011000101010011
10101001011001110111
111010100G1000011111
10001100011010000111
11100101001010110011
11010101111010001011
11010111000010111001
11011000001010000011
11000001101000101011
11010101001110101001
110101011100001010A1
11011111110111111111
11111111111111111111