Level size: 14
Polisher percentage: 50
Starter line: 11100101000110,
Whole Level:
1111111111111111
11111110111110E1
1000110000110011
1100000110011011
1101110001001011
1000000101110011
11110101G0000011
1100010110011011
1101110001001011
1101100111001001
1100100001101101
1110100011001001
1A00110001001001
1110010011101011
1111011000111111
1111111111111111