Level size: 8
Polisher percentage: 50
Starter line: 00111110,
Whole Level:
1111111111
10011110E1
1100111011
1100000011
10001A1011
1010101001
1100101101
1001100111
1G11111111
1111111111