Level size: 10
Polisher percentage: 50
Starter line: 0000011110,
Whole Level:
111111111111
1000001110E1
100000000011
100001101011
10010A101011
100101110011
110100110111
110101000111
111101011111
1G0001000111
111111101111
111111111111