Level size: 16
Polisher percentage: 50
Starter line: 1001100100101110,
Whole Level:
111111111111111111
1111111111011110E1
111000010100001011
111001110000111011
111100101110000011
110110100000111111
110110001100000011
110000101G01101101
110110101011000001
110100101110011101
110101100000100111
110100000110110111
100001111010010111
111110000000000001
1A0000101000000001
110001110010000001
111100011111000001
111111111111111111