Level size: 14
Polisher percentage: 50
Starter line: 10110110001010,
Whole Level:
1111111111111111
11111111011100E1
1100001001110111
1101100000000001
1101001001000001
1101011011000001
1101100A11010001
1100111010010001
1111011010100101
1000000010101111
1111011010100011
1G00001011110011
1110001000010111
1110101011010111
1111111011011111
1111111111111111