Level size: 10
Polisher percentage: 50
Starter line: 0000101110,
Whole Level:
111111111111
1E0001111001
100000000011
100100111011
100110010011
11011G011011
110011001011
111000101011
100011101011
111000101A11
111111101111
111111111111