Level size: 12
Polisher percentage: 50
Starter line: 011111010010,
Whole Level:
11111111111111
1A111111110001
10011000000111
11000011110011
11111100000011
10110001111011
10001100000011
11100001110111
10001101000111
11110011110111
11011000000111
11000001110001
110111011101G1
11111111111111