Level size: 14
Polisher percentage: 50
Starter line: 11000100100001,
Whole Level:
1111111111111111
111111111100A111
1101100001001111
1100001111010001
1100110000010111
1110000101010111
1010110011110001
1010110101100111
1000110100101111
1001101110000111
1000100000110011
1000110111011011
1000000000001001
1G01010011011001
1101011011111111
1111111111111111