Level size: 10
Polisher percentage: 50
Starter line: 1001101000,
Whole Level:
111111111111
1111111100A1
111000000001
100010100101
111010101111
110010100011
100111101101
111100000001
110001010101
11G101010011
111101011111
111111111111