Level size: 14
Polisher percentage: 50
Starter line: 01111010010110,
Whole Level:
1111111111111111
1A11111110111001
1001100010000011
1100111000011111
1110000001000001
1000111111011001
1111000000000101
1101111111010111
1100000000010111
1101011101010001
1111010001010111
1000000101010111
1110101001000011
10001010001010G1
1111101110111011
1111111111111111