Level size: 10
Polisher percentage: 50
Starter line: 0100100101,
Whole Level:
111111111111
1111011110A1
110101011001
110101000011
110100001111
110011100001
111000001111
100011000001
110001011011
11G010001011
111010111011
111111111111