Level size: 14
Polisher percentage: 50
Starter line: 00010000100101,
Whole Level:
1111111111111111
1A00000001111001
1001100000011001
1110101101100011
1110101100001111
1000111000100001
1110000010001011
1101110011001011
1101100001010011
1100000011010111
1111101001011111
1000001110000111
1100100110101111
11101011101000G1
1110111111111111
1111111111111111