Level size: 16
Polisher percentage: 50
Starter line: 0110000010100111,
Whole Level:
111111111111111111
111100001101111111
11A001110001110001
110100010100000111
110101011101111111
110101100101000111
110100101100010111
110100100001011011
110001111101011001
110100011001100011
100110000011001011
101000111000011011
111010011010100011
100011110010110111
111100000110011111
110001010001000001
1101110110111100G1
111111111111111111