Level size: 14
Polisher percentage: 50
Starter line: 10100001111010,
Whole Level:
1111111111111111
11A0000011111111
1101101000000111
1100101010111111
1110101010000111
1110101010111111
1001101010100011
1100001011101101
1110001000000001
1000101010101001
1110101010101011
1000111010101111
11000000101000G1
1000101000010111
1010101111110111
1111111111111111