Level size: 12
Polisher percentage: 50
Starter line: 110000111111,
Whole Level:
11111111111111
11A00001111111
11011100000011
11000110111111
11011001000111
11000000010111
11011010010011
11011011001111
11000001111001
11011100000001
11000111101011
11100000101011
111010101110G1
11111111111111