Level size: 14
Polisher percentage: 50
Starter line: 11111010110111,
Whole Level:
1111111111111111
1111111111001111
11000000000000A1
1101011110010111
1101001101010001
1101111001010101
1100000011010101
1111101000111101
1000001110000111
1100000011111111
1110001000000001
1000011011111101
1111001000000011
1000001111011111
1G11101111001111
1111111111111111