Level size: 14
Polisher percentage: 50
Starter line: 10111111110001,
Whole Level:
1111111111111111
1111111111001111
11A0010011011111
1110110100000001
1000000001111001
1110110100010101
1000011101000111
1110000111100011
1100011100001001
1101000001100011
1101010100001111
1101010101100001
1101010101100111
1101011100111101
11010000100000G1
1111111111111111