Level size: 10
Polisher percentage: 50
Starter line: 1101011100,
Whole Level:
111111111111
1111111100A1
100000000101
100111110111
111011010111
110000000001
100010010001
101010100101
111010100101
101010110101
1G0011110111
111111111111