Level size: 8
Polisher percentage: 50
Starter line: 10011011,
Whole Level:
1111111111
1111111111
111000A111
1010110011
1000001011
1001001011
1011001001
1001101001
1G01101111
1111111111