Level size: 12
Polisher percentage: 50
Starter line: 111011101110,
Whole Level:
11111111111111
11110111011001
1A000000000011
11110111111011
10000000110011
11110110100011
10000010101011
10101110101001
10101100100011
11101000101011
10001010101011
11101010101001
111110111010G1
11111111111111