Level size: 14
Polisher percentage: 50
Starter line: 00101101100101,
Whole Level:
1111111111111111
1A01111111111001
1000000000011001
1100110111000011
1111010100011111
1100011101000111
1101000000010011
1101110010111011
1100011010001011
1101100000111001
1000101010000011
1001001111011111
10010100000000G1
1101010101010111
1111011101011111
1111111111111111