Level size: 10
Polisher percentage: 50
Starter line: 1111000011,
Whole Level:
111111111111
11110000E111
100000100011
110010101001
111010111011
11001A010011
100010111011
111010001011
110010101001
100110100011
1G1111111111
111111111111