Level size: 8
Polisher percentage: 50
Starter line: 00111011,
Whole Level:
1111111111
1E01111111
1100000011
1100101001
1101A01101
1110001001
1000101011
1110101011
1111101G11
1111111111