Level size: 10
Polisher percentage: 50
Starter line: 0010100110,
Whole Level:
111111111111
1E0001111001
101101100011
110000001111
110101000001
10010G001011
101001101011
101101001011
101001100111
110011100011
1111111110A1
111111111111