Level size: 10
Polisher percentage: 50
Starter line: 1110011000,
Whole Level:
111111111111
1110000000E1
100001001001
111101011001
110001011011
111001A10011
110011010111
111010010001
111011000111
111100000011
1111G1101111
111111111111