Level size: 22
Polisher percentage: 50
Starter line: 1011111110111011111010,
Whole Level:
111111111111111111111111
111111111101111111111111
11E001000000000000000111
111011111111110101011111
100000000000000101000111
101011111101110101101111
101001000000010101100001
111101011101110100110101
100001000101000100010101
111101010110001000100111
110101010010101010100011
110111010110101001101011
11000001001G111101001011
110110111100010001011011
110100000101000101011001
110111011101001101010011
110001010000100101011011
111011110010111101011011
100000011010000100001001
101010100000111101101001
101010101010110001101011
111001101100010011001011
1111111001011110110110A1
111111111111111111111111