Level size: 10
Polisher percentage: 50
Starter line: 0111010000,
Whole Level:
111111111111
1111111000E1
110000000001
110110001001
110010111001
111100G11011
110101110011
110110000011
110000011011
11A101001011
111101111111
111111111111