Level size: 12
Polisher percentage: 50
Starter line: 100000000000,
Whole Level:
11111111111111
11E00000000001
11000000000001
11010000000001
11010000000001
11010100000001
1101011A000001
11010001000001
11011111000001
11011111010001
11011111010001
110111111001G1
11111111111111
11111111111111