Level size: 18
Polisher percentage: 50
Starter line: 101011001111001000,
Whole Level:
11111111111111111111
111111111111111100E1
11011110000001010001
11011110111101010101
11010111100001000111
11010000101101000011
11011101110001001001
10000000010101100011
11101111011000101111
110110000G0011000001
10000111111001011111
11110101101010000011
10000101000000110011
11110000011010011111
11000111101011000001
11010000000000010111
11010100101100010011
10010101001001001011
1A110111111110011111
11111111111111111111