Level size: 14
Polisher percentage: 50
Starter line: 00001110110001,
Whole Level:
1111111111111111
1E00011001001111
1000000000011111
1000101110000001
1110100011001001
1110101A00111101
1000101110011011
1110100001000011
1000110101100111
1010010111100011
1110010011001111
1100111000000G11
1110001011001111
1110101001111111
1111101111111111
1111111111111111