Level size: 8
Polisher percentage: 50
Starter line: 01010100,
Whole Level:
1111111111
11110110E1
1110001001
1100100011
1001111011
1110A00011
1110101001
1010101101
1G00111101
1111111111