Level size: 12
Polisher percentage: 50
Starter line: 000101110001,
Whole Level:
11111111111111
1E001111001111
10000000011111
11100111000001
11111000010001
100000G1000101
11001101011111
11101001000011
10001011011011
11101001001111
100011010000A1
11100101010111
11110101110111
11111111111111