Level size: 22
Polisher percentage: 50
Starter line: 1111011100100001111001,
Whole Level:
111111111111111111111111
111111111111111111111111
1E0000000001000001000111
110010010011101000010001
111111011110001011001111
101100000000101011000001
100001011111101110010111
111011000000000011110011
111000111111011000001111
100010000001000111111011
100011111000010000011001
100000000111110111100011
10110101000G000000001111
110001011110111110100001
111010000010001100111011
111010011010100110011011
100011010010110001001101
100011010110010111010001
100001010001000001110111
100101010101101100000111
110101110000100101110011
110100001010101100001A11
110111101111100111101111
111111111111111111111111