Level size: 16
Polisher percentage: 50
Starter line: 0110011011110010,
Whole Level:
111111111111111111
1E1111111111110001
100000001100000111
111110100001010111
100011111101010011
110000000001011111
110111111101000011
100000000001011011
10101111A101010011
101010000101110011
111100100100011001
110000110010000111
110110010100110011
110010011000001011
110111001101101101
1001000011011000G1
111101101111101111
111111111111111111