Level size: 12
Polisher percentage: 50
Starter line: 001100110111,
Whole Level:
11111111111111
1E011111001111
11000000000001
11011101010111
11010001010001
11010101010101
110101A1011101
11011101000111
10000001000111
11100101010001
11100101010111
111011011100G1
11111100110111
11111111111111