Level size: 14
Polisher percentage: 50
Starter line: 01001101101110,
Whole Level:
1111111111111111
11111111100110E1
1101000100100011
1100011001111011
1100111100100011
1110100101101111
1000110000100011
1010010011101001
11110000A1001101
1100110110011101
1101100111000011
1100000000011011
1101001111001011
1101000000101011
11G1011110111111
1111111111111111