Level size: 16
Polisher percentage: 50
Starter line: 1001000010000111,
Whole Level:
111111111111111111
111010000111111111
11101100010000E111
101000110001110111
100001100100000011
110111000101101011
110000010101101011
110011010111001111
100001011000000011
1001111A0011001111
100000001001100111
100010011100001111
111011000011100011
111010010000011001
111011010101000011
110001010100101111
1G0111010111101111
111111111111111111