Level size: 10
Polisher percentage: 50
Starter line: 1000101011,
Whole Level:
111111111111
110001000111
1100110100E1
100000011001
100111000101
100000111111
101110A00011
111100101111
110000100111
11G100010111
111101111111
111111111111