Level size: 12
Polisher percentage: 50
Starter line: 101101000111,
Whole Level:
11111111111111
11111111111111
110000110000E1
11111010010111
10000000110011
10101110001111
111100G0100001
11000111101101
11100011001001
11000000011101
11100010000011
1A001010101111
11111010101111
11111111111111