Level size: 12
Polisher percentage: 50
Starter line: 100000000001,
Whole Level:
11111111111111
11E00000000011
11000000000011
11010000001011
11010000001001
1101011G101011
11010111101011
11010011001011
11011000011011
11001001010011
11011101011011
10000100001011
11110111111A11
11111111111111