Level size: 20
Polisher percentage: 50
Starter line: 01111001111111000110,
Whole Level:
1111111111111111111111
11111100111111000010E1
1100000100001101000011
1101100100111001011111
1101000101010111000011
1101010100010000010011
1101010000111110011111
1101011110001100000001
1101001000100001010111
11011000111G1011010111
1100101100001000111111
1111110111101010000111
1011000000111010111111
1000111100000010100011
1110000001111010101101
1000111111100011100001
1011011000001000001101
1110000011101010101001
11A0010001001010101011
1111010011101011101111
1111011011101001100111
1111111111111111111111