Level size: 16
Polisher percentage: 50
Starter line: 0000111011010110,
Whole Level:
111111111111111111
1000011111111110E1
100000101100000011
100110101000101011
111010000010101011
111000011010111001
100010100010001101
111010111111011101
110010110G10000011
100110000010111011
111000101010110011
111010101011100011
111010101000101011
100110101100101111
110000100010100011
11A110101010101111
111110101100011111
111111111111111111