Level size: 16
Polisher percentage: 50
Starter line: 1001100111111100,
Whole Level:
111111111111111111
1111100011111100E1
111000100100110101
100001101101000111
111100000100011111
110001111101000111
111000000001101111
110011010111000001
111110010A00010111
100000111111110001
111010000000100101
100011101010101101
101001101011100111
111000101000010011
11G001000101001111
111101010101100011
111101011101101111
111111111111111111