Level size: 20
Polisher percentage: 50
Starter line: 01110110001000101101,
Whole Level:
1111111111111111111111
1E11101111110001111111
1000000011010010000011
1101110100000000111111
1100010001110101100011
1111000100010110100111
1000110001111010000111
1000000110001011010011
1011010110111000011001
1100010000000001000011
1111111011G11011101011
1000000001011010001011
1010010101011011111011
1011010101000000001011
1100010101010101100111
1101100101110101100011
1101000110000100011001
1101010110101101000011
1110010100100101111111
1100110100111000000A11
1111100110111011111111
1111111111111111111111