Level size: 10
Polisher percentage: 50
Starter line: 0100010000,
Whole Level:
111111111111
1110000000E1
111101100001
100000101001
101010101001
10101G110011
111010100011
100010101011
111011101001
101010001011
1A0011111011
111111111111