Level size: 20
Polisher percentage: 50
Starter line: 10100010000111000111,
Whole Level:
1111111111111111111111
11E1110111111100001111
1101010101000001000001
1101000001110101010111
1100001000000101010111
1101010001111101011111
1101011101000001000111
1101001001010101101111
1101001011010101100001
1001001001010100101111
1010011100G11101000001
1111000101100001010111
1000010101001011010111
1111010111011001010011
1101010000010111010111
1101010111010000010111
1101011100110101010011
1101001001100101011011
1101111000000101001011
1100000001010101101A11
1111110111011100101111
1111111111111111111111