Level size: 18
Polisher percentage: 50
Starter line: 000101100111001101,
Whole Level:
11111111111111111111
1E001111111111111111
10010000000100000011
11000101010101010011
11011101001101111011
11000111100100001111
11010000111101011011
11010110010001101001
11010001110100000001
110111000G0111011101
11000010110001110111
11010010000100000111
10011000100011110011
10000110101000001011
10110100101010101111
10110101101010100011
11000101001010111011
11101101011010001A11
11101101111011101111
11111111111111111111