Level size: 14
Polisher percentage: 50
Starter line: 01110100000011,
Whole Level:
1111111111111111
1E11111000000111
1000000000000011
1101100001101001
1100101101101011
1101000110001011
1101010010111011
1101010G10010011
1101011010111011
1101001010001011
1101101010111001
1101101010010011
1100101011010111
11111010100100A1
1111101100110111
1111111111111111