Level size: 18
Polisher percentage: 50
Starter line: 111010111010010110,
Whole Level:
11111111111111111111
11111111111111111111
10000100100011000E11
11110101101111011111
11010000100000000001
11011101101011111001
11000100001100000101
11101101111001010111
10000101000001010111
11100000001101011111
100010001G0100000111
11101100110111111111
10000010010000000001
10001111011111101001
10000001000000101011
10001100101110101111
10001110100010100001
10000010101100100111
1A111110111111110111
11111111111111111111