Level size: 8
Polisher percentage: 50
Starter line: 10011010,
Whole Level:
1111111111
11111100E1
1110000111
10001G0011
1110101001
1100100011
1A00101011
1110101011
1110111001
1111111111