Level size: 14
Polisher percentage: 50
Starter line: 00101011100001,
Whole Level:
1111111111111111
1E01000111001111
1001010000100111
1100111110110001
1110000010000111
1100101010110111
1001101111010111
1110001A00000001
1110101011011001
1000101100000001
1011000001010001
1001010011100101
1011010100001101
10110101010001G1
1111110111011111
1111111111111111