Level size: 8
Polisher percentage: 50
Starter line: 00001000,
Whole Level:
1111111111
1E00000001
1000010001
1001010101
1011G10111
1100010111
1110010111
1111010111
111111A111
1111111111