Level size: 14
Polisher percentage: 50
Starter line: 11001000110111,
Whole Level:
1111111111111111
1111111111111111
1E00001000000001
1010110011101111
1110011100100001
1100010001101111
1101011000001011
1101000A11101001
1101010000000011
1001000111010111
1010010000010001
1111010011010111
1111011010010111
11000000101100G1
1111101111110111
1111111111111111