Level size: 14
Polisher percentage: 50
Starter line: 11001110000011,
Whole Level:
1111111111111111
111E011000000111
1100100010000011
1000001010001001
1010001100101011
1010100110011011
1110101110100011
10001100G0101111
1111000010100111
1100001010110111
1101101010110011
1101101010001111
1100101111011001
11111001000000A1
1111111101111111
1111111111111111