Level size: 12
Polisher percentage: 50
Starter line: 100010111101,
Whole Level:
11111111111111
11111111111111
11100000100E11
11101000001111
10001100100001
10001111101111
100000G0100011
10011010101001
11001010100011
11011100010011
11000101111011
11A10000001011
11110101101111
11111111111111