Level size: 12
Polisher percentage: 50
Starter line: 110000000110,
Whole Level:
11111111111111
110000000010E1
11010000000011
11010000011011
11010101011001
11010101001101
110101A1111001
11010100110011
11010110001111
11010010000111
11011111010111
11G00001001111
11111101111111
11111111111111