Level size: 20
Polisher percentage: 50
Starter line: 00110100101001000000,
Whole Level:
1111111111111111111111
1E01111110111000000001
1100000100000010000001
1110110111010110100001
1000010000010100100001
1111111111010110001001
1100000000010010111001
1101101100011010011011
1101011101011011110011
1101000001001010000011
1101111011111010011011
11100000001G0011001011
1111001010111001011001
1100011010001001001101
1111100011011111101001
1100000001000110001001
1111101101010100110011
1111000101110111000111
1111111100100010010111
1111110000111111100001
11111101101111111010A1
1111111111111111111111