Level size: 14
Polisher percentage: 50
Starter line: 00010111111001,
Whole Level:
1111111111111111
1E00111111111111
1000000000001111
1110010111100001
1111110000111111
1011000111000001
1000110A00011111
1110000111001011
1000110000000011
1111000101110111
1100000100011111
1101010010000111
1101110110110011
1100010000001G11
1110110111111111
1111111111111111