Level size: 14
Polisher percentage: 50
Starter line: 10010101110101,
Whole Level:
1111111111111111
11111100111110E1
1111101001001101
1110001101101001
1100100000100011
1111101101101111
1000000000000001
11001111G1100101
1101000000010101
1111100101001111
1100111101000001
1110000001110111
1100111100001111
11A1000000100001
1111011110101001
1111111111111111