Level size: 14
Polisher percentage: 50
Starter line: 00100000110111,
Whole Level:
1111111111111111
1E00000001111111
1011001110000111
1100011000101111
1101010010110001
1101011011000111
1101000A00000011
1101111011111001
1100100000111011
1111101010000011
1000001011111111
1100010000000011
11110101011110G1
1000010100000011
1111111000111111
1111111111111111