Level size: 22
Polisher percentage: 50
Starter line: 0100110111000000111100,
Whole Level:
111111111111111111111111
1111111011000000011100E1
110000000101111000000101
111101010101101111010111
110011110100000001000011
111000000000101111111001
111010101101111000011011
100110101100011001110011
110001111001000000001111
111100000011101010100001
100001110000101010111111
10101000001G101110000011
101010111010100000101101
110011011000111110100001
111110000010111010101101
110110110110000011100111
110000110000110000010111
110110010110110101010111
110010010110010111011111
110110110100010000000111
110100110101000110100111
110111000101110010110111
11A011011100111111110111
111111111111111111111111