Level size: 24
Polisher percentage: 50
Starter line: 010010001001110010001010,
Whole Level:
11111111111111111111111111
11110000011111111111000001
11E00110110100000011110111
11011000110101010110000001
11011010100111110011000001
11010010110011101010000001
11010100000000000000100001
10010000111111101000100001
10100110100000001001001001
10110100101011101011111001
10110110010001101010111011
11001100100011001010000011
111000011100G1010010101011
10001101000111100100101011
11110001010010110110111001
11000101011110110100010011
11010101010110110100111011
11011101010000000110001011
11000101010110000110101111
11101101010110100000100111
11110111001000101110010111
11110000010001000001110011
11111111011101011000001011
11111100001001001001101A11
11111111111111111101111111
11111111111111111111111111