Level size: 10
Polisher percentage: 50
Starter line: 1111011000,
Whole Level:
111111111111
1111100000E1
100000101001
110010101001
111111101011
11000A001011
110111011011
110100010011
110100011011
100101001011
1G1101111111
111111111111