Level size: 16
Polisher percentage: 50
Starter line: 0110001001011011,
Whole Level:
111111111111111111
1E1111111111110111
100011000001010111
111000011101000001
110001000001111001
110101011100000001
110101010001110001
110101100100100101
110110001111101111
110110101A00000011
110100101010101001
110101101010100011
110111001010101011
100000011010101011
101111100010101011
100110000100101001
1001101111111111G1
111111111111111111