Level size: 10
Polisher percentage: 50
Starter line: 1001110110,
Whole Level:
111111111111
1111110010E1
111100000001
100001110101
101100011101
100001G00111
110110110011
110000001111
110100100011
110110010111
11A011111111
111111111111