Level size: 16
Polisher percentage: 50
Starter line: 0010000001110111,
Whole Level:
111111111111111111
1E0000000011101111
101100011000000001
110101101001100111
110101101011000001
110100101110110111
110111100000010001
110000101010110111
1111101G1100000001
111000110001000001
111010110101000001
111100000101010001
111001100100010001
111101001100100101
111001001001101111
111111011101000A11
111111011111111111
111111111111111111