Level size: 14
Polisher percentage: 50
Starter line: 01100101011101,
Whole Level:
1111111111111111
1E11111000111111
1000011010000011
1111000011011011
1000011001001011
1011001001011001
1010001011000011
1100011G01011111
1110001001000011
1000111101011011
1100000101001111
1000110101110001
1010100100000101
1010111111110101
10111111111101A1
1111111111111111