Level size: 8
Polisher percentage: 50
Starter line: 01111011,
Whole Level:
1111111111
1111111111
11000000E1
1101011001
1111010001
1000A10101
1000010111
1001010111
1G11110111
1111111111