Level size: 10
Polisher percentage: 50
Starter line: 1100101100,
Whole Level:
111111111111
1111111100E1
100000000101
101010101111
111010100001
11001A111111
100010000011
111001101101
111101000001
1G0001011001
111101111111
111111111111