Level size: 8
Polisher percentage: 50
Starter line: 00101100,
Whole Level:
1111111111
10011100E1
1000000101
1100101101
11011G0101
1000010111
1101010111
1101010011
1A01111111
1111111111