Level size: 18
Polisher percentage: 50
Starter line: 011100111101000101,
Whole Level:
11111111111111111111
111110111111100000E1
11010000010010011001
11010101010110001011
11011101000000100111
11000001011110100011
11101101010000101001
11110111001110100011
11110000010000101011
11001111011110111111
1110110001G110010111
11100111110010100001
11001100010110000001
10000001000110100001
11101111110000110001
10000000000010001001
10110111111010111001
10010100010010001011
1A110110000111111011
11111111111111111111