Level size: 12
Polisher percentage: 50
Starter line: 100001101100,
Whole Level:
11111111111111
111111111100E1
11000001100101
11101100000101
10001101010101
11110001010101
1100011G010101
11011000111101
11011010000111
11010010111111
11010100000001
10010001101001
1A110111101111
11111111111111