Level size: 22
Polisher percentage: 50
Starter line: 1111110110000100110100,
Whole Level:
111111111111111111111111
1111111000000111111110E1
110111101011000000001001
110111101010001101000011
110101111011111001011111
110100010000000111000011
110110011101101100011011
100000100110000110001111
111010100001110000100001
101010111100000010001111
101110001001011110100011
100001101111G10110101001
101100000000110000101011
110111101010001110101011
110110001010100001101011
110000111100111100001001
111110010001011001000001
110001110101000010010001
110100000101101000110001
110101111110001110100101
100110111000010001101111
1A1000000001110100000011
111100111101111101111001
111111111111111111111111