Level size: 24
Polisher percentage: 50
Starter line: 011111011010101100110110,
Whole Level:
11111111111111111111111111
1E111111111100011111111111
10011001000101001111001111
11001000011101100001100111
11101011110100011110001111
10000000010101010110101111
11001111000001100000110011
11011100011110001111010111
11000001000010110100000001
11011001011110000101010111
11000101001011001101010111
11010011111011000001011111
110101000010G0011111100111
11010110101101101100001111
11010010110101100000100001
11011100010100001010001111
11001101000000101011101011
11101000011110101000000011
10001101000010101111010111
11101101101011100001010001
10000001001001001011010111
10000011001011111001010111
100000011010000011010100A1
10000011001011100101010111
10000011011000111111011111
11111111111111111111111111