Level size: 20
Polisher percentage: 50
Starter line: 01111010001101110111,
Whole Level:
1111111111111111111111
1011111111111111101111
10011000000010000000E1
1100111101111011101111
1110000001001001000001
1000111101101011111111
1011000100000000000001
1111100101101011101111
1100000110001000100001
1111110010101110001111
1011010111100001100011
1000010010G01111011001
1110011000110000000011
1100001001100101011111
1111101000000101000011
1100000000110101101011
1110101010010000101111
1110101011111110100001
1100101000000010111111
1001101101011010000011
1A11100101011111111111
1111111111111111111111