Level size: 12
Polisher percentage: 50
Starter line: 011110001011,
Whole Level:
11111111111111
1E111001111111
10011011100001
11000000001001
11010111011101
10010000000011
10100111011011
111101A0010011
10000111011111
11110000000011
11000101011001
11010101001011
11111101111G11
11111111111111