Level size: 10
Polisher percentage: 50
Starter line: 0000000000,
Whole Level:
111111111111
1A0000000001
100000000001
100000000001
100000000001
100000000001
100000000001
100000000001
100000000001
100000000001
1000000000G1
111111111111