Level size: 8
Polisher percentage: 50
Starter line: 10110100,
Whole Level:
1111111111
11111110A1
1100001001
1101100011
1000001011
1010111001
1100011101
1001000111
1G11010111
1111111111