Level size: 10
Polisher percentage: 50
Starter line: 0000101100,
Whole Level:
111111111111
1A0001110001
100000000101
100100101101
100111100101
110111011111
110000000111
110101010011
110101011011
110101001011
110111111G11
111111111111