Level size: 10
Polisher percentage: 50
Starter line: 0111011100,
Whole Level:
111111111111
1111101100A1
110100010101
110100110111
110001010111
110101010111
110100000001
110100000001
110101000001
110101000001
11G111010001
111111111111