Level size: 8
Polisher percentage: 50
Starter line: 00001101,
Whole Level:
1111111111
1A00011111
1000000011
1000101011
1110101011
1100101001
1001101101
10011111G1
1000111111
1111111111