Level size: 10
Polisher percentage: 50
Starter line: 1000111000,
Whole Level:
111111111111
1111111000A1
111000001001
100010101101
110100100011
111001110111
111101000111
100001110111
111100000111
1G0000110001
111110110101
111111111111