Level size: 12
Polisher percentage: 50
Starter line: 100110001011,
Whole Level:
11111111111111
11111001111111
111000111000A1
10001100001001
11000001111101
10001100000011
10101001011011
10101101010011
10100101010111
10100101010001
10110101110011
1G110100001011
11110111111001
11111111111111