Level size: 8
Polisher percentage: 50
Starter line: 11110100,
Whole Level:
1111111111
1111111001
1A00000001
1100100011
1110000111
1000010001
1111010111
1100000011
11111110G1
1111111111