Level size: 12
Polisher percentage: 50
Starter line: 110011101000,
Whole Level:
11111111111111
111001111100A1
11000010010001
10000110000101
11110000011111
10000101000011
11111101111011
11000000001111
11010110100001
11010110111111
11010110000011
11010100101011
11G11001111111
11111111111111