Level size: 10
Polisher percentage: 50
Starter line: 0111110000,
Whole Level:
111111111111
1011110000A1
100111010001
110000011001
110111000101
110001011111
110100000111
110001010011
111011011011
100011001011
1G0000111011
111111111111