Level size: 12
Polisher percentage: 50
Starter line: 110001100100,
Whole Level:
11111111111111
110000111110A1
11010100011001
11010110011011
11010000110011
11010110000011
11011000101011
10000010101001
10101100100011
10101101110111
11101001000111
1G001011010111
11101100011111
11111111111111