Level size: 10
Polisher percentage: 50
Starter line: 0110101001,
Whole Level:
111111111111
1A1111011001
100000011011
111011001011
111000B00011
100010001111
1H0011110001
100000000101
100110111101
110010000111
111110111111
111111111111