Level size: 14
Polisher percentage: 50
Starter line: 01100101011100,
Whole Level:
1111111111111111
1A11111000110001
1000011010010101
1111000011110111
1000011001000111
1111000000011001
1011001110110001
1000B00011000101
1110H01110010111
1000000000110011
1110011111001011
1100000000011001
1111010101001101
1100010101111001
1110110100111111
1111111111111111