Level size: 14
Polisher percentage: 50
Starter line: 01010100101000,
Whole Level:
1111111111111111
11110111001100A1
1110001100010001
1100100111000101
1001110000010111
1110110111010001
1100000000010101
1101101101011101
1101001001000111
1101011011101111
1101110010000001
1100010110100101
1110100010110101
1110100100010111
1000010101111111
1111111111111111