Level size: 10
Polisher percentage: 50
Starter line: 0010001011,
Whole Level:
111111111111
1A0100011111
100110000001
110001001001
110111001101
110001100011
110100001011
100011011011
100100010011
101101011011
110001001001
111111111111