Level size: 10
Polisher percentage: 50
Starter line: 0010010000,
Whole Level:
111111111111
1001111000A1
100100000B01
110111101001
110000001001
1110H0010011
100001000111
111101010001
110001001011
111101101011
110000111111
111111111111