Level size: 8
Polisher percentage: 50
Starter line: 01100011,
Whole Level:
1111111111
100000A111
1100100011
111110B001
1000000011
110010H011
1101110011
1001110111
1001111111
1111111111