Level size: 14
Polisher percentage: 50
Starter line: 01111001001011,
Whole Level:
1111111111111111
1A11111111111111
1001101001100001
1101101011101001
1100001011001101
1101001001000011
1111100B00001111
1100000001110001
1111110H00000101
1010011001111101
1000111000000111
1110000010100011
1000010110101011
1111010010111001
1111100110011011
1111111111111111