Level size: 8
Polisher percentage: 50
Starter line: 10101000,
Whole Level:
1111111111
11101100A1
1100010001
1101000101
1101101101
1101100101
1101000101
1001010101
1011010111
1111111111