Level size: 12
Polisher percentage: 50
Starter line: 111011100100,
Whole Level:
11111111111111
111101111110A1
10000000001001
11100110011011
10000011110011
11101000000111
10001111111011
11000000000011
10001101101111
10100100100011
10101000000111
10101001110111
11101101110111
11111111111111