Level size: 8
Polisher percentage: 50
Starter line: 00101010,
Whole Level:
1111111111
10011000A1
1001000111
1100010111
1111110001
1000000111
1010110111
1011000111
1011110111
1111111111