Level size: 14
Polisher percentage: 50
Starter line: 10000100000010,
Whole Level:
1111111111111111
1100B000000000A1
1100001000000101
1001101011010101
1010001011010111
1010001001010111
10101010H0010001
1110101000111001
1000101010000101
1100101011101111
1101101010000011
1000001011001111
1110001000101111
1110100110011111
1111001111111111
1111111111111111