Level size: 12
Polisher percentage: 50
Starter line: 111011110011,
Whole Level:
11111111111111
11111111101111
1A000000000001
11110101010111
10000111010111
11111000010001
11000111010111
11010000010111
11010110110001
10011010110111
10100000000111
11101010010001
11101111110101
11111111111111