Level size: 12
Polisher percentage: 50
Starter line: 001110101010,
Whole Level:
11111111111111
1A011111001111
11000000010111
11001111010111
11010000010001
1111100B000111
110011000H0011
11010001100011
11010110001011
11011000111011
11000111000011
11010000001001
11010111101011
11111111111111