Level size: 12
Polisher percentage: 50
Starter line: 000000110100,
Whole Level:
11111111111111
1A000001111001
1BH00000001001
10000010100011
10001010001011
10001011101011
11101000010011
11101001010111
10001101011111
11000101000111
11010101101111
11010101000001
11011101101111
11111111111111