Level size: 8
Polisher percentage: 50
Starter line: 00010111,
Whole Level:
1111111111
1A00111111
1000000001
1110011111
1110000011
1000101011
1100101011
1111110011
11111100G1
1111111111