Level size: 20
Polisher percentage: 50
Starter line: 11000011010010011011,
Whole Level:
1111111111111111111111
111A000111110111111111
1101110000000100011111
1101111111011100000011
1101110001001100111011
1100110111010000001011
1110100001010100111001
1000000101010101011011
1110110101010000000011
1100011101011101011111
1101100100000101001011
1100101111110101111001
1110100011000000111011
1110101110011100000011
1100100100100101111111
1000101100101100000011
1110001010101001011011
1000100000000001001011
1110100000000100101011
1110101000000111110011
10001111000101111100G1
1111111111111111111111