Level size: 10
Polisher percentage: 50
Starter line: 0000011001,
Whole Level:
111111111111
1A0000111111
100000000111
100001110001
100100100101
100110101101
110010100111
111010111111
100010000001
1100101010G1
111110101111
111111111111