Level size: 18
Polisher percentage: 50
Starter line: 101001101000101011,
Whole Level:
11111111111111111111
11A11111110001000111
11011000011010011001
11000010100000110001
11111010111010000101
11100010000010111111
11000111011110001011
11110100010110011011
11100001010000100011
11101011011110110111
11101110100000010111
11110000000010100001
11000111110110000001
11100001000110100001
11001111111100110001
11111000000000001001
10000011010101011001
11101011010101001011
11111111110111111G11
11111111111111111111