Level size: 16
Polisher percentage: 50
Starter line: 0110100000101110,
Whole Level:
111111111111111111
1011110000011110A1
100000000000001011
110110010100111011
100011110111000011
100100000000011011
101110010111001011
110000010000101011
111101010110101011
101101010011111011
100001011001110111
111010001000000111
111010011101110111
100011010000010111
100011100101010111
100100001101001111
1G1111111111101111
111111111111111111