Level size: 18
Polisher percentage: 50
Starter line: 001100101000001000,
Whole Level:
11111111111111111111
1A011111000000000001
11000000010000010001
11111010100101010101
11100011101101010111
11001000111001010111
11100010000001010001
11101100010101010111
11110111010101001111
11000000010001000001
11010101011011100111
11010101001000100011
11010101111010111011
11010100000010001011
11010101110111011001
11010100000010001101
110101010101101110G1
11010101010010010011
11110111100111111111
11111111111111111111