Level size: 8
Polisher percentage: 50
Starter line: 00111010,
Whole Level:
1111111111
10011111A1
1100000101
1110110001
1000000111
1110110111
1011000111
1G00010111
1101011111
1111111111