Level size: 8
Polisher percentage: 50
Starter line: 01101100,
Whole Level:
1111111111
1A11110001
1001100101
1100000101
1101010101
1111010111
1100010111
1110110001
11101101G1
1111111111