Level size: 20
Polisher percentage: 50
Starter line: 00010001000001101001,
Whole Level:
1111111111111111111111
10001000000000111110A1
1000110111110000000011
1110000000110101101111
1110110110100100100011
1000000010111111111111
1000001111000000001111
1000000000011101000001
1000001100110101011001
1000001110000101000101
1000000010110100011111
1000011010110001100011
1001001000010101101011
1001011111010100001011
1101000001010111111011
1101011101010000111111
1111011101010111111111
1000001001010011111111
1010111111011111111111
1G10010000000011111111
1111110111111011111111
1111111111111111111111