Level size: 22
Polisher percentage: 50
Starter line: 0100101010100110111010,
Whole Level:
111111111111111111111111
111101101101111001111111
11A001000001100000000111
110101010100001010111111
110101110111101110100111
110100000101100001100011
110101110100001100001011
110101000101000101011001
111101010001011101000011
100001010101001001101011
111111010101101000101011
110000010100001010101111
110111011101110010000001
110001000100000111010111
110110001000100001010111
100011000110101101010001
100100011100101001011001
100101000101101001000101
110011110100101100101101
111011110101000101000101
111011100101010101011111
111100001101010101000011
111111111101010101111G11
111111111111111111111111