Level size: 20
Polisher percentage: 50
Starter line: 01011011010101011100,
Whole Level:
1111111111111111111111
1111110111100111111111
11A0010100100000010111
1101000001101011110111
1100011010001000010111
1101011110111111010001
1101000010000101110001
1101011111010100100101
1101010000011101001111
1101110101100101100011
1100100100101000001001
1101111110101101100011
1100001000101000001111
1101111011000011100001
1100101010011001100101
1110101000000100011101
1000101111010011000111
1110000010011000010011
1100111110110111001111
1000010100000000000G11
1111000000110101100111
1111111111111111111111