Level size: 8
Polisher percentage: 50
Starter line: 11101110,
Whole Level:
1111111111
11110110A1
1000000011
1111111011
1000110011
1110000011
1000101011
1010101001
1G11111011
1111111111