Level size: 16
Polisher percentage: 50
Starter line: 0010110110010110,
Whole Level:
111111111111111111
1111111111111110A1
111100000001010011
110011001101010111
110100011101010111
110101100001010001
110101001011000111
110111010000101111
110000000101100001
111110011000101111
100011100010100011
100000001010101011
101101111010100111
110001000010001111
110101011110101001
100111010000100001
1G0011111110110001
111111111111111111