Level size: 14
Polisher percentage: 50
Starter line: 00011111001010,
Whole Level:
1111111111111111
1A00111111110001
1000011101100111
1010000000000011
1100011111101011
1111010000001111
1000000101100001
1110101110001011
1000110000100111
1110010110100011
1101010110101001
1101010110100011
1100111100101011
1110000001101111
11111111100000G1
1111111111111111