Level size: 14
Polisher percentage: 50
Starter line: 01000101001000,
Whole Level:
1111111111111111
11111001110000A1
1110100010011001
1000101010110101
1110101010000111
1000101010111111
1110110010010111
1000000000110111
1110110110010111
1011000000000011
1000010110111011
1101011100001011
1101000110011001
11G1110110001011
1111110110101011
1111111111111111