Level size: 12
Polisher percentage: 50
Starter line: 010011000001,
Whole Level:
11111111111111
1111111000A111
11010001011011
11010111011011
11000011001001
11011000000011
10001010001111
10101110100001
11000001101111
11011100000011
10000001011001
10110101000011
1G011111111011
11111111111111