Level size: 14
Polisher percentage: 50
Starter line: 01101101000111,
Whole Level:
1111111111111111
1A11011111111111
1000000011000001
1101010000010111
1101010110010011
1101110001001111
1101100111011011
1100110001101001
1110000111000001
1000110000001101
1010010111101001
1110010000101001
1100111010111011
1110001010000111
111111101111G111
1111111111111111