Level size: 10
Polisher percentage: 50
Starter line: 1110010010,
Whole Level:
111111111111
1111111100A1
100011000111
110001110011
110100111011
100000000011
111010101011
100010101011
110100101001
100110011001
1G1111111111
111111111111