Level size: 10
Polisher percentage: 50
Starter line: 0110111000,
Whole Level:
111111111111
1111111000A1
110000001001
110101101101
110101000011
111001100111
111111100011
110000001001
110101000011
11G101010111
111000110111
111111111111