Level size: 20
Polisher percentage: 50
Starter line: 01010001010100000110,
Whole Level:
1111111111111111111111
1110111110011111111111
1110110110100000000A11
1110000100101010111111
1000010001101010100011
1001111110001011101101
1000000000111000001001
1001101010001111111001
1000101000100100000011
1011101010111001100111
1111101010000011100011
1100001011111001001001
1110001000000011100011
1000100100011011101111
1110100101011001000001
1000110101000111101111
1100010100100000100111
1101010110101010101111
1101010100111011100111
11G1010110001000011111
1111010010111011001111
1111111111111111111111