Level size: 22
Polisher percentage: 50
Starter line: 1010111110010100010111,
Whole Level:
111111111111111111111111
11A011111111101110111111
110001011011000010000111
110111010000000110111111
110010011011010000001011
110111010001010111110011
110001010101010000000111
110111011001010111111011
110001001010000000000011
111100001010001110101111
100011101000100010000011
100001100100001111111111
101100000101110000000001
110001010100000111101001
110101011101111101101011
110101000100000000101111
110101110001111111100001
110101001100000000011111
110111000001011101000111
110001111011110101010011
111110000000000101011111
100000101010101101000011
100111111011101101111G11
111111111111111111111111