Level size: 16
Polisher percentage: 50
Starter line: 0111100001000111,
Whole Level:
111111111111111111
1A1111111111111111
100001011000110111
110101011010000111
110101000011111011
100111011001000011
101000000011011111
100011111000000011
100000001010111111
100011011010100011
100001100111101101
100001110000000001
100000000101111101
100010111100100011
111010000010001111
111010101010100111
11101111101111G111
111111111111111111