Level size: 12
Polisher percentage: 50
Starter line: 101011110001,
Whole Level:
11111111111111
11100111001111
11010011011111
110110100000A1
11000000111001
11111010010101
10000011110111
11001000000111
11101001010001
10001100111001
11001100000101
10011101010111
1G000111011111
11111111111111