Level size: 14
Polisher percentage: 50
Starter line: 10110000101100,
Whole Level:
1111111111111111
11111011111100A1
1100000101000101
1110110100011111
1100010101000001
1111000000011111
1100110011000011
1110001100011011
1110100110001111
1000110000100001
1111001111101111
1101100000000011
1100001010101001
11G0111010100011
1110111010110111
1111111111111111