Level size: 16
Polisher percentage: 50
Starter line: 1010110101000000,
Whole Level:
111111111111111111
11A001111000000001
110100000010000001
110111111100100001
110001000001100001
110110001000101001
100011101011001001
100100001001010011
101101011011010111
110001010001010001
110101011111010111
110111001000010111
111000111011110001
111010000010000101
1110110110101101G1
111111110010010111
111111000111110111
111111111111111111