Level size: 22
Polisher percentage: 50
Starter line: 0100001001000100010110,
Whole Level:
111111111111111111111111
1110000111100000001110A1
111100111110011101000011
100000011100001000011111
111000001101011010100001
110110110000000011001001
110110110111111101011101
110000000000110000011011
110110110110000101000011
110110010010111101010111
110100011010000101011111
110101011010100100000111
110101001010101111111111
110011111010100000000001
111010111011001010101001
110010000001001010101011
100010101011100110101111
111010101000110010100001
110010101010110110100101
100010011110100010110101
1G1001010000101100010111
111111010010100101000011
111111011010100011111111
111111111111111111111111