Level size: 24
Polisher percentage: 50
Starter line: 111100110110010001000110,
Whole Level:
11111111111111111111111111
111111111111111111111110A1
11000000000001011000110011
11010101101101010010011011
11010101101110000111001011
11010100010010010000101011
11110101110011011110101011
11000100011001000011110011
11101111100011011101110111
10000000101000000000000111
10100111000011011111110001
10110000011110100000000111
11111011100000101101010111
11000010001011101001000011
11111010111000001111011001
10000000000111100100000011
11001010110011010101011111
11111010001000011101000011
11011000101111000001101011
11000010111000111100101111
11011010000010000010100001
11001010110110101011111111
11101010010010101000000001
1G001001011110111101011001
11101111001110011101011111
11111111111111111111111111