Level size: 22
Polisher percentage: 50
Starter line: 0001011111010001000111,
Whole Level:
111111111111111111111111
1A0011111111100011111111
100000000000100110110001
111001101011100000000111
111111001000001011111011
101100011111111011100011
100001000000011000001111
110001101101001011100011
110100101001111000011111
110110111000000011000001
110110010010101001010111
110001001010101101110001
110101001010000100100101
110101011000010110101101
110111011011010010100111
110001000011011110110011
110100011001011000001011
100001001101001000101101
100101000101011010100001
100101011101000110101101
110101011011010110101001
1101010100100101001010G1
100110000111110111101111
111111111111111111111111