Level size: 12
Polisher percentage: 50
Starter line: 010010111101,
Whole Level:
11111111111111
11110111111111
11010000100A11
11000110001111
11010001100001
11011100001111
11000111100011
11010011001001
10001001100011
10001100001111
11101001100001
11001100100111
1G011110111111
11111111111111