Level size: 8
Polisher percentage: 50
Starter line: 10110111,
Whole Level:
1111111111
1111101111
11000000A1
1100110111
1101000001
1111010111
1100010111
1110110001
1G00110101
1111111111