Level size: 14
Polisher percentage: 50
Starter line: 00011101101110,
Whole Level:
1111111111111111
1A00111111111001
1000000000001011
1001011101111011
1101000100000011
1101000101011111
1101010101001111
1101010101000001
1100111100111001
1110000010000101
1100101010111111
1001101010100011
1101001011101101
11010100000000G1
1111110111111111
1111111111111111