Level size: 12
Polisher percentage: 50
Starter line: 111001110010,
Whole Level:
11111111111111
11100011111111
1A001000000111
11110001011111
11010101000011
11010101011111
11011101000001
11000001001111
11111101000001
10000001110111
10101000001111
10110001100001
101111011010G1
11111111111111