Level size: 18
Polisher percentage: 50
Starter line: 111101111001111101,
Whole Level:
11111111111111111111
11111011100011111111
10000000101000000A11
11001010000110101111
11111010000001100001
10000010110000011111
11001010110111000011
11011110100001101011
11010000100100101011
11010101101110110011
11010100100010110111
11010110101010100111
11010010011100011111
11010111000101000111
11010100010100100011
11010101100110101111
11100100101000100011
1G000010101010110111
11101110101110111111
11111111111111111111