Level size: 22
Polisher percentage: 50
Starter line: 1001111001011000101110,
Whole Level:
111111111111111111111111
1111111111111111111110A1
111000001100000000000011
100011100001011101111011
111010111001000100010011
100010000011101101011111
110011111010001001000011
110000100011101111101011
110110101100000001101111
110110100101011000000001
111001110101011011001111
111100000101010011000001
100001011110000110010111
101101011000010010010011
101001001011010111001011
110011111010010100011011
111010111010110101001001
110010010010100101111001
100110111110100100110011
111000000000100000000111
110010111110101100100001
11G110001000000010101111
111111111011111110100001
111111111111111111111111