Level size: 18
Polisher percentage: 50
Starter line: 111110011000100111,
Whole Level:
11111111111111111111
11111111111111111111
1100010100110000A111
11010101010001110111
11011100000100011111
11000111010011000111
11110000011000010011
10000011110111001111
10011001000000000011
11100011010101110111
11101000010100011111
10100011110111000111
10001100010000110011
11100001011100011011
10001100110101001101
11101100000101011001
10001101011101000011
10000010000111011111
1G000110110011001111
11111111111111111111