Level size: 14
Polisher percentage: 50
Starter line: 11000010101001,
Whole Level:
1111111111111111
11A0111100111111
1100000000011111
1101010101001111
1101101111100011
1100000000011111
1101001011000001
1001101001010111
1000101011110001
1010101000100111
1010101010110111
1010111010010111
1010000001010111
1010110111010111
100111000011G111
1111111111111111