Level size: 24
Polisher percentage: 50
Starter line: 101110001000111000011011,
Whole Level:
11111111111111111111111111
1111111111111110000011A111
11000011010110001101000111
11111010010010101101010111
10000011011010100111010111
11001000001000111000011111
11111011010010000011000111
10000000010110111100010011
11101111010000100001001111
11010001010101001111100011
11011001010110000000001111
11001011000011011111100001
11100000001111000000111111
11001011100011010101100001
11011010001000011110101111
10000010101111100010000011
10101100100000001110101011
10101101110111100000101111
11101001000000101101100011
10001010001010100100110111
11101010101010011101110001
10001010101010000100001001
11010010101010001101111001
11011110101001101000011011
11G11111111111101111011011
11111111111111111111111111