Level size: 16
Polisher percentage: 50
Starter line: 1011000010100111,
Whole Level:
111111111111111111
111100001101111111
1100011101011100A1
110011000100000101
110001000011101101
110110011110000111
110011010101100011
111000010101001011
110011110000011001
110001100011000011
110110001001111011
110011011100010011
111000001001011111
111011001101000011
100000100101010011
100110110101010111
1G0111110111110111
111111111111111111