Level size: 14
Polisher percentage: 50
Starter line: 00100100101010,
Whole Level:
1111111111111111
1A01101101001111
1001000000000111
1101110101010111
1100010101010001
1110111101010111
1000000001010111
1010101001000011
1010101000101001
1111001010100011
1100011010001111
1110001011100011
1100010000101001
11110101100110G1
1111010111111111
1111111111111111