Level size: 20
Polisher percentage: 50
Starter line: 00000111110011011100,
Whole Level:
1111111111111111111111
10000011111011001100A1
1000000110101100000101
1000010000000001010111
1001000110101111011111
1001010110110000000011
1101010110111010111011
1101010010000010001011
1101010110110011111001
1001010100100000011011
1000010111110101010011
1001010000010001000111
1001010001011000100111
1101010101001001101111
1101010111001100101111
1101010001100100101111
1101011100011110101111
1101000011000010100111
1101110001001010101111
11G0011101111100111111
1110001100111111111111
1111111111111111111111