Level size: 12
Polisher percentage: 50
Starter line: 011101110111,
Whole Level:
11111111111111
10111011101111
100000000000A1
11011111101111
11011000000001
11010011101111
11010100000001
11110101101101
11000101100101
11101101000101
10000101010101
10101101010111
1G011101011111
11111111111111