Level size: 8
Polisher percentage: 50
Starter line: 11110110,
Whole Level:
1111111111
1111101001
1A00001011
1100101011
1101110011
1100010111
1101110111
1100000001
11101101G1
1111111111