Level size: 10
Polisher percentage: 50
Starter line: 1101010101,
Whole Level:
111111111111
111111011001
1A0000001101
100110100001
111000101101
111111101001
100011001101
111000010001
100010100111
111010101111
1111111000G1
111111111111