Level size: 14
Polisher percentage: 50
Starter line: 01100111101111,
Whole Level:
1111111111111111
111A001111011111
1100100001000111
1111100101010011
1010110011011111
1000110101010111
1001000101010011
1001110001011011
1000001100001011
1011100000011011
1111110010100011
1100000110110111
1101111010010111
1001100000000001
10011011000000G1
1111111111111111