Level size: 14
Polisher percentage: 50
Starter line: 11010111101011,
Whole Level:
1111111111111111
1111111111111111
1A00000100000001
1001110001111001
1101000100000101
1100010011010111
1101001011011011
1100011110101001
1101000000100011
1101011001101011
1101001111001011
1101100000001011
1100011111101011
1101000000101011
10011111101110G1
1111111111111111