Level size: 12
Polisher percentage: 50
Starter line: 111011101000,
Whole Level:
11111111111111
11110111110001
1A000000000001
10101111000101
10100100001111
11110101000011
10000101010011
11010001111011
11010100100011
11010100111011
11010101100011
11010101101011
111111111010G1
11111111111111