Level size: 18
Polisher percentage: 50
Starter line: 011000010111001100,
Whole Level:
11111111111111111111
111101111111100100A1
11000101000000100101
11010000011100101111
11011111100000100011
11011000001010101011
11000110011010100111
11101110100010001111
10000000100110101001
10100110101000100001
10110010101010100001
11111010110010001001
11000001000100101001
11111111010101101011
11010000010100101011
11011101010101101011
11G00001010101001011
11111101010101011011
11111101110111111011
11111111111111111111