Level size: 18
Polisher percentage: 50
Starter line: 011100001111010011,
Whole Level:
11111111111111111111
1A110000011111111111
10000110000100000001
11010111110111010111
11010011000100010111
11011110010111110011
11001000110000001011
11111010001101100001
10000011011010001101
11001110000011101001
11100000110000001101
10001010100011111001
11001010101010000011
11011010101001101111
10000111101010000001
11110000001010100101
10000111101010100101
11111000001010101101
111111111011111110G1
11111111111111111111