Level size: 20
Polisher percentage: 50
Starter line: 10110100100111011010,
Whole Level:
1111111111111111111111
11111111011111111100A1
1100000000000101000111
1111110111010101010011
1000110011011000011001
1010001110010011001011
1110100011010000111011
1000110111000010000011
1111000000110111111111
1100010110000100000011
1101011000101101111001
1101010010100100000011
1101110100110000111111
1100010101000110000011
1111100101011000101011
1000111101011101111011
1000011101000000001011
1G10000011010101101011
1100111000010100101011
1111000010010101101011
1111111011010111111111
1111111111111111111111