Level size: 8
Polisher percentage: 50
Starter line: 11110000,
Whole Level:
1111111111
11110000A1
1000010001
1100110001
1110100101
1000111101
1011011001
1100000001
11G1111111
1111111111