Level size: 10
Polisher percentage: 50
Starter line: 1010010011,
Whole Level:
111111111111
11A110111111
110110000011
110010110111
111000000111
100010110001
111010000111
100011111111
110000000001
1001010110G1
101101011111
111111111111