Level size: 10
Polisher percentage: 50
Starter line: 1100110111,
Whole Level:
111111111111
111111001111
1100000000A1
100001010111
111111010001
110000010101
110110011101
110010000111
110110100111
100110110001
1G0111110111
111111111111