Level size: 12
Polisher percentage: 50
Starter line: 001100011100,
Whole Level:
11111111111111
1A000000110001
11100100000101
11111101010111
11000001010111
11010110011111
11010010000111
11010110100111
11010100100001
11110101101111
10000111000011
111100010010G1
11110111101011
11111111111111