Level size: 10
Polisher percentage: 50
Starter line: 0000100010,
Whole Level:
111111111111
1000000000A1
100001101111
100101000001
100101101101
110101100101
110101000111
110101010111
110101110111
110100110111
11G111110111
111111111111