Level size: 12
Polisher percentage: 50
Starter line: 010011100111,
Whole Level:
11111111111111
11111110001111
110110001000A1
11000010001111
11001110100011
11100000101001
10001110100011
11101000101011
10001010111111
11101110000011
10000000111011
10100110001011
1G010110111001
11111111111111