Level size: 12
Polisher percentage: 50
Starter line: 000010000100,
Whole Level:
11111111111111
100000000000A1
10000100001001
10010101101011
10010101001011
11001111011011
11100001110011
10001100010011
10100101111011
11100100001111
11G01110101111
11100010101111
11111110111111
11111111111111