Level size: 16
Polisher percentage: 50
Starter line: 0110111010000110,
Whole Level:
111111111111111111
1011111111111110A1
100000000000000011
110100110010101011
100110010110101001
100011111000101001
101010000010101011
101010101010111111
110010101010000011
110100101010111011
110100100010001011
110110110100101001
111111000101101011
110000001000101011
110111011011101011
100100010001001011
1G0111111111111011
111111111111111111