Level size: 16
Polisher percentage: 50
Starter line: 1100011111011110,
Whole Level:
111111111111111111
1100001111111110A1
110100011000000011
111101000010101011
110011111110111111
111000110000010111
110010000110000001
100111010100100001
111000010101100001
111011110101001001
110000110101011001
111110000101011011
110000110101100011
111010100100101111
111010110110100001
1G0010010010001111
111011111111101111
111111111111111111