Level size: 18
Polisher percentage: 50
Starter line: 111111100111010010,
Whole Level:
11111111111111111111
111111100011111100A1
11000000110000000111
11011110010111111011
11001011010000000011
11111011011011111011
10000011000001101011
11001000010101100111
11111011111001100011
11011000000011001001
11000010100001000011
11011000110101101011
11001011000100001011
11010001010101011011
11010111011101001011
11011000001001100011
11010001011100101011
10010101000010101001
1G110111111110111011
11111111111111111111