Level size: 10
Polisher percentage: 50
Starter line: 0001010010,
Whole Level:
111111111111
1A0000110001
100110110111
111010000011
111010101011
100011101011
110000001011
100011111011
101010000011
111010101G11
111110111111
111111111111