Level size: 20
Polisher percentage: 50
Starter line: 11110110111101101011,
Whole Level:
1111111111111111111111
1111111001111111111111
1A00000000100000000001
1100100011001110111001
1111101011010001000101
1101101000010101010111
1101000000110111010111
1101110101000000011111
1100000101010011000111
1110111101011001010111
1100011001000111010111
1111000011010001010011
1100110011010101011111
1101100000011101011011
1100001101000111001001
1101011100011000111001
1110001001000010000011
1100111101011111111111
1111100001110000000001
10000010000000111110G1
1111111011110001111111
1111111111111111111111