Level size: 14
Polisher percentage: 50
Starter line: 10101000100011,
Whole Level:
1111111111111111
11A0111101111111
1100010101011011
1101010000001001
1101110011100011
1100000101101111
1110110101100001
1001000101000101
1001111000010101
1000001111010111
1011101100010111
1111000001110001
1100001000100111
1101101010101111
11111011101000G1
1111111111111111