Level size: 18
Polisher percentage: 50
Starter line: 100100010001110101,
Whole Level:
11111111111111111111
111011101111111110A1
11101110101100001101
10100000000001111001
10000101111100100011
11010101000110001111
11010111010001100001
11010000011101001111
11011111000111100011
11000000011000001001
11101111111101100011
10000000000000001111
10100001010101100001
10100101010101100111
11110101010100111111
11000111010100000111
11011000010101010011
11G11010110101001011
11111010010111111111
11111111111111111111