Level size: 10
Polisher percentage: 50
Starter line: 1001100111,
Whole Level:
111111111111
111111001111
1110001000A1
100001101111
111100000011
110001101001
110110000011
110011100111
110110000011
100110011001
1G0111011011
111111111111