Level size: 16
Polisher percentage: 50
Starter line: 0011001011101000,
Whole Level:
111111111111111111
1A0111111111110001
110000000000010001
111110101011000101
100000101011010111
110011101010010111
111101101011010011
100000001110111011
101000100000001011
101010010010101011
111010011010100111
100011001000010111
110001011011010111
110101010011010111
1110010101000100G1
110001110101000111
111100110111011111
111111111111111111