Level size: 18
Polisher percentage: 50
Starter line: 010001111110101011,
Whole Level:
11111111111111111111
11111111111111000111
111011000100010110A1
10000001010110010001
11111110000000100101
11010110111110101111
11010000111000100001
11000011000010001111
11111101011110100011
10000000001110101001
11001111000000100011
11101011011110101011
11001011010000101111
10011000010111101001
11100010110100000001
11101010010101100001
11001011110101001001
11G10001000010011101
11110111011111111111
11111111111111111111