Level size: 12
Polisher percentage: 50
Starter line: 001001001000,
Whole Level:
11111111111111
100100110000A1
10010101011001
11010101000101
11000001010111
11101110011111
10000000000111
11110110100111
10000010110111
10100010010111
1G101001000011
11101001111111
11101101111111
11111111111111