Level size: 18
Polisher percentage: 50
Starter line: 011000110100011011,
Whole Level:
11111111111111111111
1A000001111111110111
11001000001101000111
11111011110001110111
10001000010110000111
11001011100011110001
11011000101101110101
11000010100100000101
11010011110101111101
11010100010000110111
11010110110111000111
11010000000000010001
11010110110111000111
11010100010000011111
11110101111011110001
10000100100000000101
101101101010101011G1
10010010111011100111
10011110011000011111
11111111111111111111