Level size: 14
Polisher percentage: 50
Starter line: 00101111110000,
Whole Level:
1111111111111111
10011111110000A1
1000000000010001
1100111111011001
1110100001000101
1010001000011111
1010111111100011
1010000000001011
1000111100101011
1000000111111011
1000110000110111
1000110101000111
1000001100011111
1G01101001000111
1101101111101111
1111111111111111