Level size: 14
Polisher percentage: 50
Starter line: 10111101001111,
Whole Level:
1111111111111111
1111111111111111
11A0110000000011
1110001001010011
1000011011110111
1110001000011111
1100000011000111
1111100000010011
1100110011001111
1110000000100011
1100010110001111
1101010010100001
1101010010101111
1101010010100011
11110110101110G1
1111111111111111