Level size: 10
Polisher percentage: 50
Starter line: 0111111000,
Whole Level:
111111111111
1111111000A1
110001101001
110100001001
111000010011
100001000111
111101010001
110001001011
110101001011
11G101011111
111101111111
111111111111