Level size: 12
Polisher percentage: 50
Starter line: 101101000001,
Whole Level:
11111111111111
11111110000A11
11000000000011
11011000101011
10001010101001
10101110100011
11000100101011
10001101110011
10100100010111
11111101010111
11000001010111
11010011010001
11G11011110101
11111111111111