Level size: 16
Polisher percentage: 50
Starter line: 1000001101110011,
Whole Level:
111111111111111111
110000011111111111
1101110000000100A1
110110001011100111
111000101100001111
110011100101100001
111100000000011111
100001010101000011
111111010101111011
110001010100001111
110101110111100001
110100000000001011
110101110101001011
110101000111010011
111101010001111111
1G0001001100000011
111111111000011111
111111111111111111