Level size: 8
Polisher percentage: 50
Starter line: 10111000,
Whole Level:
1111111111
11111000A1
1100001001
1111101001
1000001011
1100101011
1101110011
1001000111
1G01111111
1111111111