Level size: 18
Polisher percentage: 50
Starter line: 000101110001110110,
Whole Level:
11111111111111111111
1A001111000011001111
10001001010000000011
11100011010101110111
11101000010100011111
10100011110111000111
10001100010000111111
11100001011100011011
10001100110101001001
11101100000101111001
10001001011101000011
10011001100111011111
10001100100000000111
10001111101011010011
10000110001000111011
10010000111010001011
11000100011011110G11
11110101000000010111
11110111011111011111
11111111111111111111