Level size: 18
Polisher percentage: 50
Starter line: 010110001001011100,
Whole Level:
11111111111111111111
111111111111111100A1
11000011000000000101
11010110011111110111
11100010000000000011
11001000011111101011
11111011000000101111
10000001011101100001
11001101000111001011
11111100010001100111
11000001000111100011
11010101010011001001
11010101110000100011
11010100011110001111
11010101001100100001
11010100100001101111
11011100101100000011
11G00110100101001001
11101111111101101011
11111111111111111111