Level size: 12
Polisher percentage: 50
Starter line: 111101110010,
Whole Level:
11111111111111
11111111111111
1A000000000111
11001001011111
11111101100011
10110000001111
10000101110001
11101100000101
11100011111101
10001001110111
10001100000111
10000011110001
101110011101G1
11111111111111