Level size: 22
Polisher percentage: 50
Starter line: 1010011001111000010110,
Whole Level:
111111111111111111111111
11A111110111111111111001
110110000010001100000011
110000111010101101010111
111111000010110001110001
101100011010100100001001
100001001010101111101101
111011111000000000100011
110000110001101010101011
111110000100011001111011
110000111101000100000111
111010101101010101010111
111010100001010111000011
100011001001010011001111
110001011011110000100011
110111010000011110001111
100000010111001100100111
111101010000100001101111
110101010110101100000011
110101010011000101011111
110111010001011101000011
110000010110001001111011
111011110110111100111G11
111111111111111111111111