Level size: 16
Polisher percentage: 50
Starter line: 0100111001111011,
Whole Level:
111111111111111111
111111100011111111
1101100010010000A1
110100100000011001
110011101011111001
111000001001000101
100011011111010111
111000000000010111
100010111011110001
111010001000110111
100011011010000011
111100000111101011
110001010000111001
110101010110011011
110101100001000011
110100101001100111
11G111111011111111
111111111111111111