Level size: 8
Polisher percentage: 50
Starter line: 11001110,
Whole Level:
1111111111
11100110A1
1100100011
1000001011
1111111011
1000110011
1110000011
1G00101011
1110101001
1111111111