Level size: 18
Polisher percentage: 50
Starter line: 010100000110110110,
Whole Level:
11111111111111111111
111A0000001101111111
11101111010100000011
11111011010101011111
11110010010101101011
10000000100100001001
10101100101001101011
11101100101000001011
11000110001011111011
11010000100000000011
11010111100101100111
11010010110011100011
11010110110001001001
11011100000101100011
10000001000100001111
11111101010001000001
11000001010101011011
11010101010101001011
11110111010111111G11
11111111111111111111