Level size: 10
Polisher percentage: 50
Starter line: 1110100010,
Whole Level:
111111111111
1111110000A1
100001100111
111101000001
101100010111
100011110001
111000000101
110010110101
1G0100010111
111000110111
111110111111
111111111111