Level size: 16
Polisher percentage: 50
Starter line: 1110000111101101,
Whole Level:
111111111111111111
111000001111111111
1A0011000100000011
110011111001110011
110001100011101011
110110001000001111
110010111111100011
111000000000001111
111011010111100001
100010010000101111
100110111110100001
100011011010111111
100010000011100011
100000111000001101
1001000001100100G1
110101010110000111
111101111110111111
111111111111111111