Level size: 20
Polisher percentage: 50
Starter line: 00011001001100101010,
Whole Level:
1111111111111111111111
10001111111111110000A1
1000000001000011010111
1001010111110000010111
1101010010010111110001
1100010110100001110101
1110100000001100000101
1010101110100111111101
1011110000110001110111
1000000111100100000111
1011010010001111110001
1100010100100000110101
1101011101110111100101
1101000101000000011101
1101111101010101000111
1101011001010100101111
1101000001010110100001
1101010101010010001011
1101111101011111101011
1101001001000000101011
11G1100011111111111111
1111111111111111111111