Level size: 8
Polisher percentage: 50
Starter line: 10100001,
Whole Level:
1111111111
11A0000011
1101110011
1100111001
1110000111
1000111111
1000011001
11010000G1
1101111111
1111111111