Level size: 8
Polisher percentage: 50
Starter line: 00101001,
Whole Level:
1111111111
1A00010011
1011000111
1100010111
1101010011
1101111011
1000000001
1110111001
11111000G1
1111111111