Level size: 24
Polisher percentage: 50
Starter line: 101100100000000111010000,
Whole Level:
11111111111111111111111111
111110110000000011111000A1
11000011100000000000100001
11101000001011010110001001
11001010101011010000111101
10011010101011010010011011
11100010101011011000110011
11101010101011001010000011
10001110101001001000101011
11110000101111101110101011
11000101000000101100101111
11010101010110100111100011
11010101010001110000010111
10011111110101000101010111
10001000000111101101011111
11110010110000100101000111
11000010010110110001101111
11011001010010110101000001
11001010011010100101100101
11111100001010111100010101
10100110011010000011000111
1G001110100011101011010111
11100000101001001010010111
11101101101111111010111111
11111111100111111011111111
11111111111111111111111111