Level size: 10
Polisher percentage: 50
Starter line: 0011001000,
Whole Level:
111111111111
1001111100A1
110000110001
111010110101
100010000111
110011010011
110110011001
110100000011
110101101011
110101101011
11G101111111
111111111111