Level size: 14
Polisher percentage: 50
Starter line: 01010111100100,
Whole Level:
1111111111111111
11100011111110A1
1110100000001001
1000111101101011
1011000000100011
1111010101111111
1100010100001111
1100011101000001
1101010001011001
1101100011000101
1100111000101101
1111000010100101
1100010110101111
1001010100100011
1G11010111101111
1111111111111111