Level size: 16
Polisher percentage: 50
Starter line: 1101101010010110,
Whole Level:
111111111111111111
1110111101101110A1
100000000110000011
100000010011011111
100001000110000001
100001100000111001
100101100100000101
100100010101100111
110011001100100011
110001000011101011
110101011001101011
110101001011011111
110101011110000011
110111000000111111
110001111110001111
111000000001101111
111G11111111101111
111111111111111111