Level size: 16
Polisher percentage: 50
Starter line: 0100101111000110,
Whole Level:
111111111111111111
1111011111000010A1
110001001101000011
110101011001011111
110100000001000011
110111001101011011
110001000101001111
110110011101100001
100011100000100101
100100001000110101
101101101010110111
110000101000000011
110101001010101011
100101011010101001
1G1001001010100011
111111111010010111
111111111011110111
111111111111111111