Level size: 22
Polisher percentage: 50
Starter line: 0101110001010010010101,
Whole Level:
111111111111111111111111
11111111111011011110A111
110000011000110001101011
111111000010011100001011
100000011100001110111011
101011000000100000000011
101000011110101110111011
111010001000101000001011
101100111010101010101101
100111000010111010100001
110110011111000010101101
110000100001111011101001
111010101011000010001101
100011101000010110101001
111100001011100010101011
110111110011101110101011
110000000001001000101011
110101101111101010101001
111101001000001010100011
100001111011111010010011
111010000001100011011011
111010101110001001001011
111G11101110111101111111
111111111111111111111111