Level size: 18
Polisher percentage: 50
Starter line: 111100110111000001,
Whole Level:
11111111111111111111
11111111001110000111
11A10000000101010011
11010101010100011011
11010101110111011001
11010100001000000011
11010101011010111111
11001101010010000011
11100001111010101001
10001100111000101001
11110000000011100111
11000110111000010111
11010110001001010111
11010100101010011111
11010110111010000111
11010010110011100111
11010010011000100001
11011111000010101111
110011110111101000G1
11111111111111111111