Level size: 12
Polisher percentage: 50
Starter line: 001011011000,
Whole Level:
11111111111111
100111111000A1
10010000101001
11001000001101
11011001100011
11011011101011
11000000001011
11011011101011
11011000101011
11010010101111
11010010100001
11011010111111
11G01110011111
11111111111111