Level size: 22
Polisher percentage: 50
Starter line: 1111010000001000100111,
Whole Level:
111111111111111111111111
111111100000011111111111
1A0000000000000111000111
110010000101010011010111
111000010101011000011111
100011011101110111000111
111100100000000000010011
110110110010101101001111
110110111010100011100011
110000000011101000101111
110110101000101010100001
110110101010110001111111
110100101010110100011111
110101101010100101001101
111000101110111101111001
110001000100001100000011
111101011110100101011111
100001001000111101110001
110101100010010000000111
110100101010010101111111
110110101011001000000111
110010101011010010101111
1111101110110111101000G1
111111111111111111111111