Level size: 8
Polisher percentage: 50
Starter line: 00100001,
Whole Level:
1111111111
1000000A11
1001001011
1101011001
1101000111
1101101111
1101000001
1101010111
1G01110111
1111111111