Level size: 20
Polisher percentage: 50
Starter line: 11000001110010001000,
Whole Level:
1111111111111111111111
11A0000011111111000001
1101110100010011110001
1100011101010110000101
1101011011000010110111
1101110000001111010111
1100000110100001000001
1111111000111100011001
1110001001000001000001
1000101111100101010001
1100101110001111010101
1101000000100100010111
1110011111110000100011
1111100000000110101011
1000000010110010101011
1100101010011000110011
1111101010110010010011
1000001110100111011011
1100000011110001001111
11100011000001010000G1
1110111111011111110111
1111111111111111111111