Level size: 10
Polisher percentage: 50
Starter line: 0000111110,
Whole Level:
111111111111
1A0001111001
100000111011
100010000011
111000101011
111010101011
100010011111
110010000011
111010111111
111010000G11
111011111111
111111111111