Level size: 14
Polisher percentage: 50
Starter line: 00101100111110,
Whole Level:
1111111111111111
1A01111111111001
1000000000111011
1100101010000011
1111101010111011
1000001011011011
1100100000001101
1101101101010001
1101000101000111
1101101101010111
1100100101010011
1110101110001011
1000100010111001
11101010100010G1
1111101011111111
1111111111111111