Level size: 12
Polisher percentage: 50
Starter line: 101011010111,
Whole Level:
11111111111111
11A00111111111
11011000000001
11011011111111
11000000000011
11011010011111
10001010000011
10010011011111
10010001000111
11010101010001
11010101011001
110011010001G1
11111111010111
11111111111111