Level size: 16
Polisher percentage: 50
Starter line: 0110001011110000,
Whole Level:
111111111111111111
1111111111110000A1
110000000000010001
111111011110111001
111100010000100101
110001011110101111
111110001000001011
111010111010101001
100011001110100001
100011100000101101
100000000111101001
101110111000001101
110000101101111001
111110100001000011
111000101001001011
11G010101101001011
111111100111011011
111111111111111111