Level size: 16
Polisher percentage: 50
Starter line: 0011110110000000,
Whole Level:
111111111111111111
111111100000000001
111A00001010000001
110000101010000001
110101111010100001
111000100010100001
110010000111001001
111000110100011001
111011100101001011
111100000101111011
110000110000100011
111110011010000111
111110111010110001
111110010010100101
1111111110101011G1
111111000011000111
111111111001011111
111111111111111111