Level size: 12
Polisher percentage: 50
Starter line: 011010100000,
Whole Level:
11111111111111
1A111100000001
10000001000001
11101110010001
11101000110001
10001100010101
11001000100111
11011110100011
11010000111011
11010100001011
11010100011001
110101110010G1
11011111111111
11111111111111