Level size: 18
Polisher percentage: 50
Starter line: 000010000111110010,
Whole Level:
11111111111111111111
1A000111111111111111
10000000000111000111
10010101110000010111
10010100001111010011
11001110100110011011
11100010010001001011
11001011101111001011
10001000100001100111
11101010101100100011
11101011100010101001
11001000001010100011
10001010111010011111
11101010001110000001
11001011000010010111
10001001010111011111
10100101010001000G11
11111101010101011111
11111101011111011111
11111111111111111111