Level size: 12
Polisher percentage: 50
Starter line: 010100100101,
Whole Level:
11111111111111
111111111110A1
11111111011001
11010111000011
11010011101111
11011001000001
11000011101111
11110010000001
10000010101111
11001011100001
11111000001111
10000001100011
1G011000000111
11111111111111